AANHITW	Hilton Al Ain
ABEAWGI	Hilton Garden Inn Allentown West
ABEGIGI	Hilton Garden Inn Allentown Bethlehem Airport
ABEHWHW	Homewood Suites Allenton West
ABGVAHX	Hampton Inn Abingdon
ABIABGI	Hilton Garden Inn Abilene
ABIHSHX	Hampton Inn and Suites Abilene-I-20, TX
ABISWHX	Hampton Inn Sweetwater, TX
ABITXHX	Hampton Inn Abilene
ABQAAGI	Hilton Garden Inn Albuquerque Airport
ABQAPHW	Homewood Suites by Hilton Albuquerque Airport
ABQCOHX	Hampton Inn and Suites Albuquerque-Coors Rd, NM
ABQDUHT	Home2 Suites by Hilton Albuquerque/Downtown-University, NM
ABQEMES	Embassy Suites by Hilton Albuquerque
ABQHWHW	Homewood Suites by Hilton Albuquerque Uptown
ABQMTHX	Hampton Inn Albuquerque-University
ABQNJHX	Hampton Inn and Suites Albuquerque North/I-25
ABQRRGI	Hilton Garden Inn Albuequerque North/Rio Rancho
ABQUPGI	Hilton Garden Inn Albuquerque Uptown, NM
ABRSDHX	Hampton Inn and Suites Aberdeen, SD
ABYDRHX	Hampton Inn and Suites Albany, GA
ABYGIGI	Hilton Garden Inn Albany, GA
ABZACGI	Hilton Garden Inn Aberdeen City Centre
ABZCRGV	Hilton Grand Vacations at Craigendarroch Suites
ABZDTDI	DoubleTree by Hilton Aberdeen City Centre
ABZTTHN	Hilton Aberdeen Treetops
ACTHMHW	Homewood Suites by Hilton Waco, TX
ACTKLGI	Hilton Garden Inn Killeen, TX
ACTSOHX	Hampton Inn Waco-South
ACTWCHX	Hampton Waco North
ACTWHHF	Hilton Waco
ACVCAHX	Hampton Inn and Suites Arcata, CA
ACYHWHW	Homewood Suites by Hilton Atlantic City/Egg Harbor Township
ACYVIHX	Hampton Inn and Suites Vineland, NJ
ADAHIHI	Adana HiltonSA
ADDHITW	Hilton Addis Ababa
ADDILHX	Hampton Inn and Suites Chicago/Addison
ADEGAHX	Hampton Inn Adel
ADLHITW	Hilton Adelaide
ADWCSHX	Hampton Inn and Suites Camp Springs/Andrews AFB, MD
AEXLAHX	Hampton Inn and Suites Alexandria, LA
AEXLVHX	Hampton Inn Leesville, LA
AEXMVHX	Hampton Inn and Suites Marksville, LA
AGOCAHX	Hampton Inn and Suites Agoura Hills
AGOHWHW	Homewood Suites by Hilton Agoura Hills
AGOSNHX	Hampton Inn Magnolia, AR
AGPGIGI	Hilton Garden Inn Malaga, Spain
AGPRHDI	DoubleTree by Hilton Resort & Spa Reserva del Higueron
AGRDTDI	DoubleTree by Hilton Agra
AGSAGGI	Hilton Garden Inn Augusta, GA
AGSAWHT	Home2 Suites by Hilton Augusta, GA
AGSCUQQ	The Partridge Inn Augusta, Curio Collection by Hilton
AGSDTDT	DoubleTree by Hilton Augusta
AGSGAHX	Hampton Inn Augusta Washington Rd.
AGSGHHX	Hampton Inn Augusta/Gordon Highway, GA
AGSSCHW	Homewood Suites by Hilton Augusta
AGSTHHX	Hampton Inn Thomson, GA
AGSWEHX	Hampton Inn and Suites Augusta West
AHNDTGI	Hilton Garden Inn Athens Downtown
AHNGAHX	Hampton Inn Athens
AHNMDHX	Hampton Inn Madison+++
AIDINHX	Hampton Inn Anderson
AIKGIGI	Hilton Garden Inn Aiken
AIKSCHX	Hampton Inn Aiken
AISFLHX	Hampton Inn Amelia Island @ Fernandina Beach, FL+++
AISHSHX	Hampton Inn & Suites Amelia Island-Historic Harbor Front+++
AKLHIHI	Hilton Auckland
AKLLTHI	Hilton Lake Taupo
ALBAHGI	Hilton Garden Inn Albany Airport
ALBAPHX	Hampton Inn & Suites Albany-Airport+++
ALBCPGI	Hilton Garden Inn Clifton Park+++
ALBESES	Embassy Suites by Hilton Saratoga Springs
ALBHHHF	Hilton Albany
ALBHSHX	Hampton Inn & Suites Albany-Downtown+++
ALBHWHW	Homewood Suites by Hilton Albany+++
ALBJCGI	Hilton Garden Inn Albuquerque/Journal Center
ALBMCGI	Hilton Garden Inn Albany Medical Center+++
ALBSAHF	The Saratoga Hilton
ALBSMDT	DoubleTree by Hilton Albuquerque
ALBSSGI	Hilton Garden Inn Saratoga Springs
ALBSUGI	Hilton Garden Inn Albany/Suny Area
ALBSYHX	Hampton Inn Schenectady+++
ALBTYGI	Hilton Garden Inn Troy+++
ALBUAHX	Hampton Inn Albany-Western Ave/University Area, NY
ALBULHX	Hampton Inn Albany-Wolf Road+++
ALDVAHX	Hampton Inn Richmond-North/Ashland+++
ALETXHX	Hampton Inn Alpine+++
ALLHWHW	Homewood Suites Allentown/Bethlehem-Airport
ALLPAHX	Hampton Inn Allentown
ALMHHHX	Hampton Inn Alamogordo
ALOCFGI	Hilton Garden Inn Cedar Falls
ALOIAHX	Hampton Inn Waterloo
ALSCOHX	Hampton Inn Alamosa, CO
ALTAHHF	Hilton Orlando-Altamonte Springs
ALWWAHX	Hampton Inn and Suites Walla Walla, WA
ALYACHI	Hilton Alexandria Corniche
ALYGPHI	Hilton Alexandria Green Plaza
ALYKRHI	Hilton Alexandria King's Ranch
AMAAMHT	Home2 Suites by Hilton Amarillo, TX
AMABOHX	Hampton Inn and Suites Borger, TX
AMADUHX	Hampton Inn and Suites Dumas, TX
AMAGIGI	Hilton Garden Inn Amarillo, TX
AMAHWHW	Homewood Suites by Hilton Amarillo
AMAPPHX	Hampton Inn Pampa,TX
AMATBHX	Hampton Tomball TX
AMAWEHX	Hampton Inn and Suites Amarillo West, TX
AMEGAHX	Hampton Inn Americus, GA
AMMDSHI	Hilton Dead Sea Resort & Spa
AMSAAHX	Hampton by Hilton Amsterdam Airport Schiphol
AMSADDI	Doubletree by Hilton Amsterdam - NDSM Wharf
AMSAPHI	New Hilton Amsterdam Airport Schiphol
AMSCSDI	DoubleTree by Hilton Amsterdam Centraal Station
AMSHHHI	Hilton The Hague
AMSHITW	Hilton Amsterdam
AMSLNGI	Hilton Garden Inn Leiden
AMSWAWA	Waldorf Astoria Amsterdam, Netherlands
AMSZUHX	Hampton by Hilton Amsterdam /  Arena Boulevard
AMWGIGI	Hilton Garden Inn Ames, IA
AMWIAHX	Hampton Inn Ames
ANBHSHX	Hampton Inn and Suites Oxford/Anniston
ANBJVHX	Hampton Inn Jacksonville-Anniston Area, AL
ANBODHT	Home2 Suites by Hilton Oxford, AL
ANBOXGI	Hilton Garden Inn Oxford/Anniston
ANCAGGI	Hilton Garden Inn Anchorage
ANCAHHF	Hilton Anchorage
ANCAKHX	Hampton Inn Anchorage
ANCESES	Embassy Suites by Hilton Anchorage
ANCHWHW	Homewood Suites by Hilton Anchorage
ANDGIGI	Hilton Garden Inn Anderson, SC
ANDMDHX	Hampton Inn and Suites Annapolis
ANDNOHX	Hampton Inn Anderson/Alliance Business Park, SC
ANDSCHX	Hampton Inn Anderson, SC
ANKGIGI	Hilton Garden Inn Ankara
ANKHITW	Ankara HiltonSA
ANPDTDT	DoubleTree by Hilton Annapolis
AOOPAHX	Hampton Inn Altoona
APCNHGI	Hilton Garden Inn Napa
APCSCHX	Hampton Inn and Suites Suisun City, CA
APFBOHW	Homewood Suites by Hilton Bonita Springs/Naples-North
APFBSHX	Hampton Inn Bonita Springs/Naples North
APFFLHX	Hampton Inn Naples I-75
APFGSDT	DoubleTree Suites by Hilton Naples
APFNHHF	Hilton Naples
APFTTHX	Hampton Inn Naples/Central
APLHHHX	Hampton Inn Appleton
AQJDTDI	DoubleTree by Hilton Aqaba
ARBGIGI	Hilton Garden Inn Ann Arbor, MI
ARBGRHX	Hampton Inn Ann Arbor North
ARBVWHX	Hampton Inn Ann Arbor South
ARKARHX	Hampton Inn Arkadelphia, AR
ARLAHHF	Hilton Arlington, TX
ARTGIGI	Hilton Garden Inn Watertown/Thousand Islands
ARTNYHX	Hampton Inn Watertown, NY
ARXNPHX	Hampton Inn Neptune/Wall, NJ
ASBNCHX	Hampton Inn Asheboro
ASHNHHX	Hampton Inn Nashua, NH
ASPDADI	DoubleTree by Hilton Alice Springs
ASRHIHI	Hilton Kayseri
ASTORHX	Hampton Inn and Suites Astoria, OR
ATHHITW	Athens Hilton
ATHTNHX	Hampton Inn Athens, TN
ATLAAHH	Hilton Atlanta Airport
ATLAHHH	Hilton Atlanta
ATLALGI	Hilton Garden Inn Atlanta North Alpharetta
ATLAMGI	Hilton Garden Inn Atlanta Midtown, GA
ATLANDT	DoubleTree by Hilton Atlanta-Airport
ATLAPHW	Homewood Suites by Hilton Atlanta/Alpharetta
ATLARES	Embassy Suites by Hilton Atlanta-Alpharetta
ATLATHX	Hampton Atlanta Airport
ATLBHDT	DoubleTree by Hilton Atlanta-Buckhead
ATLBUHX	Hampton Inn Atlanta Buckhead
ATLCAGI	Hilton Garden Inn Cartersville, GA
ATLCLHW	Homewood Suites by Hilton Atlanta-Galleria/Cumberland
ATLCMHX	Hampton Inn Atlanta -Cumberland Mall
ATLCNHX	Hampton Inn Atlanta/Canton, GA
ATLCPHX	Hampton Inn and Suites Atlanta Airport W/Camp Creek Pkwy, GA
ATLCVHX	Hampton Inn Covington, GA
ATLCWDT	DoubleTree Suites by Hilton Atlanta-Galleria
ATLCYHX	Hampton Inn Conyers
ATLDHHX	Hampton Inn Atlanta North Druid Hills
ATLDLGI	Hilton Garden Inn Atlanta West/Lithia Springs, GA
ATLDMHX	Hampton Inn Atlanta/Lawrenceville/I-85-Sugarloaf, GA
ATLDOGI	Hilton Garden Inn Atlanta Downtown
ATLDVHX	Hampton Inn Atlanta/Douglasville
ATLEPGI	Hilton Garden Inn Atlanta Airport North, GA
ATLESES	Embassy Suites by Hilton Atlanta Centennial Park
ATLFBHX	Hampton Inn Atlanta/Fairburn, GA
ATLFRHX	Hampton Inn Arlanta/Marietta
ATLFYHX	Hampton Inn Fayetteville, GA
ATLGIGI	Hilton Garden Inn Atlanta Airport Millenium Center
ATLGLES	Embassy Suites by Hilton Atlanta-Galleria
ATLGRHX	Hampton Inn and Suites Atlanta Galleria
ATLGSGI	Hilton Garden Inn Atlanta NE/Gwinnett Sugarloaf
ATLGTHX	Hampton Inn Atlanta-Georgia Tech/Downtown, GA
ATLGWHX	Hampton Inn and Suites Atlanta/Duluth
ATLHMHX	Hampton Inn Atlanta Perimeter Center
ATLHPHF	Hilton Atlanta-Northeast
ATLHSHX	Hampton Inn & Suites Atlanta-Downtown,GA
ATLJCGI	Hilton Garden Inn Atlanta North/Johns Creek
ATLKEGI	Hilton Garden Inn Atlanta NW/Kennesaw Town Center
ATLKNHW	Homewood Suites by Hilton Atlanta NW-Kennesaw Town Ctr
ATLKSES	Embassy Suites by Hilton Atlanta - Kennesaw Town Center
ATLLADT	DoubleTree by Hilton Atlanta NE/Northlake
ATLLVHX	Hampton Inn - Atlanta/Lawrenceville/Gwinnett Co., GA
ATLLXES	Embassy Suites by Hilton Atlanta-Buckhead
ATLMAHF	Hilton Atlanta/Marietta Hotel & Conference Center
ATLMCGI	Hilton Garden Inn Atlanta South-McDonough
ATLMGHX	Hampton Inn - Atlanta-Mall of Georgia, GA
ATLMIHW	Homewood Suites by Hilton Atlanta Midtown, GA
ATLMOHX	Hampton Inn Atlanta/McDonough, GA
ATLMRHX	Hampton Inn and Suites Alpharetta
ATLNBHX	Hampton Inn and Suites Atlanta Airport North
ATLNDDT	DoubleTree by Hilton Atlanta North Druid Hills/Emory Area
ATLNLHX	Hampton Inn Atlanta Northlake
ATLNOHX	Hampton Inn Alpharetta/Roswell
ATLNPGI	Hilton Garden Inn Atlanta Northpoint
ATLNXHX	Hampton Inn Norcross, GA
ATLPCHX	Hampton Inn Atlanta Peachtree City
ATLPDHF	Hilton Suites Atlanta-Perimeter
ATLPEHW	Homewood Suites by Hilton Atlanta-Peachtree
ATLPHGI	Hilton Garden Inn Atlanta Perimeter Center, GA
ATLPMHW	Homewood Suites by Hilton Atlanta Buckhead
ATLPTHX	Hampton Inn Atlanta/Peachtree Corners/Norcross, GA
ATLPWES	Embassy Suites by Hilton Atlanta-Perimeter Center
ATLRSDT	DoubleTree by Hilton Atlanta/Roswell
ATLSBHX	Hampton Inn Atlanta/Stockbridge
ATLSCGI	Hilton Garden Inn Atlanta East/Stonecrest, Ga
ATLSFHX	Hampton Inn and Suites Atlanta-West/Six Flags, GA
ATLSLHX	Hampton Inn Atlanta Southlake
ATLSMHX	Hampton Inn Atlanta/Stone Mountain
ATLSPES	Embassy Suites by Hilton Atlanta-Airport
ATLSSDT	DoubleTree by Hilton Atlanta Downtown
ATLTCHX	Hampton Inn Atlanta Town Center/Kennesaw
ATLTLHW	Homewood Suites by Hilton Atlanta Airport North, GA
ATLTYGI	Hilton Garden Inn Atlanta/Peachtree City
ATLWDDT	DoubleTree by Hilton Atlanta Alpharetta - Winward
ATLWSHX	Hampton Inn Woodstock
ATLWWGI	Hilton Garden Inn Atlanta NW/Wildwood
ATLWYDT	DoubleTree by Hilton Atlanta NW/Marietta
ATWAKGI	Hilton Garden Inn Appleton/Kimberly
ATYSDHX	Hampton Inn and Suites Watertown, SD
AUAHHHH	Hilton Aruba Caribbean Resort & Casino
AUBALHX	Hampton Inn Auburn
AUHAMHI	Hilton Capital Grand Abu Dhabi, UAE
AUHHITW	Hilton Abu Dhabi
AUOAPGI	Hilton Garden Inn Auburn/Opelika
AUOLNHX	Hampton Inn and Suites Lanett - West Point, AL
AUOOPHX	Hampton Inn and Suites Opelika, AL
AUSAAGI	Hilton Garden Inn Austin NW/Arboretum
AUSAHHF	Hilton Austin-Airport
AUSANGI	Hilton Garden Inn Austin North, TX
AUSAPHX	Hampton Inn and Suites Austin Airport
AUSBPDT	DoubleTree by Hilton Austin Northwest Arboretum
AUSBTHX	Hampton Inn and Suites Bastrop, TX
AUSBUHX	Hampton Inn & Suites Austin South/Buda
AUSCCHX	Hampton Inn and Suites Austin/Cedar Park-Lakeline, TX
AUSCDHT	Home2 Suites by Hilton Austin/Cedar Park, TX
AUSCLES	Embassy Suites by Hilton Austin-Central
AUSCVHH	Hilton Austin
AUSDTHX	Hampton Inn and Suites Austin-Downtown/Convention Center, TX
AUSESES	Embassy Suites by Hilton Austin-Arboretum
AUSFLDT	DoubleTree Suites by Hilton Austin
AUSGIGI	Hilton Garden Inn Austin Downtown Convention Center
AUSHWHW	Homewood Suites by Hilton Austin/South
AUSIMDT	DoubleTree by Hilton Austin-University Area
AUSLGHX	Hampton Inn La Grange, TX
AUSLKES	Embassy Suites by Hilton Austin-Downtown-Town Lake
AUSLNDT	DoubleTree by Hilton Austin
AUSMFHX	Hampton Inn Marble Falls
AUSNHHX	Hampton Inn Austin North
AUSNWHX	Hampton Inn Austin/Arboretum
AUSRKHX	Hampton Inn Austin/Roundrock
AUSROHW	Homewood Suites by Hilton Austin/Round Rock, TX
AUSRRGI	Hilton Garden Inn Austin/Round Rock
AUSSLHW	Homewood Suites by Hilton Austin-Arboretum/NW
AUSSOHX	Hampton Inn Austin Airport
AUSTDHT	Home2 Suites by Hilton Austin North/Near the Domain, TX
AUSUAHX	Hampton Inn and Suites Austin @ The University/Capitol, TX
AUWWIHX	Hampton Inn Wausau
AVLAPHX	Hampton Inn and Suites Asheville Airport
AVLBMDT	DoubleTree by Hilton Biltmore Hotel-Asheville
AVLBPHF	Hilton Asheville Biltmore Park
AVLHNHX	Hampton Inn Hendersonville
AVLHWHW	Homewood Suites by Hilton Asheville-Tunnel Road, NC
AVLMRHX	Hampton Inn Marion
AVLRRHX	Hampton Inn Asheville
AVLTUHX	Hampton Inn Asheville Tunnel Road
AVPHDHX	Hampton Inn and Suites Wilkes-Barre/Scranton, PA
AVPNTHX	Hampton Inn & Suites Newtown, PA
AVPNWHW	Homewood Suites by Hilton Newtown - Langhorne, PA
AVPSCHX	Hampton Inn Scranton @ Montage Mountain
AVPWIGI	Hilton Garden Inn Wilkes Barre
AXEHWHW	Homewood Suites by Hilton Alexandria/Pentagon South, VA
AXEVAHX	Hampton Inn Alexandria Pentagon S, VA
AXNMNHX	Hampton Inn and Suites Alexandria, MN
AXSOKHX	Hampton Inn and Suites Altus, OK
AYSHHHX	Hampton Inn Waycross
AZOKAHX	Hampton Inn Kalamazoo, MI
AZOKPHW	Homewood Suites by Hilton Kalamazoo/Portage, MI
AZOOMHX	Hampton Inn and Suites Kalamazoo
BALAMHX	Hampton Inn and Suites Baltimore/Arundel Mills
BALARHW	Homewood Suites by Hilton - Baltimore/Arundel Mills, MD
BALATHX	Hampton Inn Baltimore/Washington Inter. Airport
BALBAHW	Homewood Suites by Hilton Bel Air, MD
BALBWHW	Homewood Suites by Hilton Baltimore/Washington Intl Apt
BALCBHX	Hampton Inn Columbia
BALCLHW	Homewood Suites by Hilton Columbia, MD
BALCMHW	Homewood Suites by Hilton Columbia/Laurel, MD
BALCOHX	Hampton Inn and Suites Columbia-South, MD
BALCYHX	Hampton Inn Baltimore/Camden Yards, MD
BALEGHX	Hampton Inn & Suites Baltimore/Aberdeen-South
BALGRHX	Hampton Inn Baltimore/Glen Burnie
BALHVES	Embassy Suites by Hilton Baltimore-North
BALHWHW	Homewood Suites by Hilton Baltimore, MD
BALIAES	Embassy Suites by Hilton Baltimore-At BWI Airport
BALIHHX	Hampton Inn and Suites Baltimore Inner Harbor
BALWHHT	Home2 Suites by Hilton Baltimore/White Marsh, MD
BALWLHX	Hampton Inn and Suites Baltimore/Woodlawn, MD
BALWMHX	Hampton Inn Baltimore/White Marsh
BAQACGI	Hilton Garden Inn Barranquilla
BAQHXHX	Hampton Inn Barranquilla, Colombia
BASINHN	Hilton Basingstoke
BATHNHN	Hilton Bath City
BATMSHX	Hampton Inn Batesville
BCBGIGI	Hilton Garden Inn Blacksburg, VA
BCNDMHI	Hilton Diagonal Mar Barcelona
BCNHITW	Hilton Barcelona
BCNLMDI	DoubleTree by Hilton Hotel & Conference Centre La Mola
BCNMADI	Alexandra Barcelona, a DoubleTree by Hilton
BCTBCWA	Boca Beach Club, FL
BCTBRGI	Hilton Garden Inn Boca Raton
BCTECDT	Waterstone - A DT Resort By Hilton
BCTFLHX	Hampton Inn Boca Raton
BCTHSHF	Hilton Suites Boca Raton
BCTNWES	Embassy Suites by Hilton Boca Raton
BCTRCWA	Boca Raton Resort & Club
BDGNJHX	Hampton Inn Philadelphia/Bridgeport
BDLCDDT	DoubleTree by Hilton Bristol, CT
BDLETDT	DoubleTree by Hilton Bradley-International Airport
BDLGHGI	Hilton Garden Inn Hartford South/Glastonbury
BDLWHGI	Hilton Garden Inn Hartford North/Bradley Intl Airport
BDOHIHI	Hilton Bandung
BDQHXHX	Hampton Inn Vadodara Alkapuri
BDRCTHW	Homewood Suites by Hilton Stratford, CT
BDRSMHX	Hampton Inn and Suites Stamford, CT
BDRSTHF	Hilton Stamford
BDSTWHX	Hampton Bardstown, KY
BDTNJHX	Hampton Inn Bordentown
BEDWOGI	Hilton Garden Inn Worcester, MA
BEHCWGI	Hilton Garden Inn Benton Harbor / St. Joseph
BEHMIHX	Hampton Inn St. Joseph, MI
BEKWVHX	Hampton Inn Beckley
BELPAHX	Hampton Inn Belle Vernon, PA
BENVTHX	Hampton Inn Bennington, VT
BERHITW	Hilton Berlin
BERWAWA	Waldorf Astoria Berlin
BEYHGHI	Hilton Beirut Habtoor Grand Hotel
BEYMPHI	Hilton Beirut Metropolitan Palace
BFATXHX	Hampton Inn and Suites Buffalo, TX
BFDPAHX	Hampton Inn Bedford
BFFNEHX	Hampton Inn and Suites Scottsbluff
BFLBAGI	Hilton Garden Inn Bakersfield
BFLWPHX	Hampton Inn and Suites Bakersfield - Hwy 58, CA
BFNSCHX	Hampton Inn and Suites Bluffton Sun City
BFPPAHX	Hampton Inn Center Township, PA
BFSHITW	Hilton Belfast
BFSTPHN	Hilton Belfast Templepatrick Golf & Country Club
BFTSCHX	Hampton Inn Beaufort
BGIHIHH	Hilton Barbados, BB
BGMHSHX	Hampton Inn and Suites Binghamton/Vestal
BGMNYHX	Hampton Inn Binghamton/Johnson City
BGMOWHX	Hampton Inn Owego, NY
BGMVEHW	Homewood Suites by Hilton Binghamton/Vestal, NY
BGMWSDT	DoubleTree by Hilton Binghamton
BGNOHHX	Hampton Inn Bowling Green
BGRBAGI	Hilton Garden Inn Bangor
BGRSKHX	Hampton Inn Bangor, ME
BGTHWHW	Homewood Suites by Hilton Brighton, MI
BHBEWHX	Hampton Inn Ellsworth/Bar Harbor, ME
BHMBMHX	Hampton Inn Birmingham/Bessemer
BHMCOHX	Hampton Inn Birmingham Colonnade
BHMCUQQ	The Redmont Hotel-Curio By Hilton
BHMCVHX	Hampton Inn and Suites Birmingham/Pelham
BHMDNHX	Hampton Inn & Suites Birmingham-Downtown/Tutwiler, AL
BHMDTDT	DoubleTree by Hilton Birmingham
BHMEAHX	Hampton Inn and Suites Birmingham Airport Area, AL
BHMFDHX	Hampton Inn Fultondale
BHMHMHW	Homewood Suites by Hilton Birmingham-SW-Riverchase-Galleria
BHMHOES	Embassy Suites by Hilton Birmingham/Hoover
BHMHWHW	Homewood Suites by Hilton Birmingham South-Inverness, AL
BHMJSHX	Hampton Inn Jasper, AL
BHMLBHX	Hampton Inn and Suites Birmingham/280 East-Eagle Point, AL
BHMLDGI	Hilton Garden Inn Birmingham/Lakeshore Drive
BHMLEHX	Hampton Inn Birmingham/Leeds, AL
BHMLPGI	Hilton Garden Inn Birmingham SE/Liberty Park
BHMLSHX	Hampton Inn Birmingham I-65/Lakeshore Dr, AL
BHMMBHX	Hampton Inn Birmingham/Mountain Brook
BHMPPHF	Hilton Birmingham Perimeter Park
BHMRCHX	Hampton Inn and Suites Birmingham-Riverchase/Galleria, AL
BHMTRGI	Hilton Garden Inn Birmingham/Trussville, AL
BHMTUGI	Hilton Garden Inn Tuscaloosa
BHMTVHX	Hampton Inn Birmingham/Trussville
BHMWCES	Embassy Suites by Hilton Birmingham
BHMWIHX	Hampton Inn Winfield, AL
BHNWVHX	Hampton Inn Buckhannor
BHXBNHX	Hampton Inn - Birmingham City North - GHE,UK
BHXBPGI	Hilton Garden Inn Birmingham Brindleyplace
BHXBRHN	Hilton Birmingham Bromsgrove
BHXBSHX	Hampton Inn Birmingham Broad Street
BHXMETW	Hilton Birmingham Metropole
BHXPHHN	Hilton Puckrup Hall, Tewkesbury
BILBMGI	Hilton Garden Inn Billings, MT
BILHWHW	Homewood Suites by Hilton Billings, MT
BILMTHX	Hampton Inn Billings
BILWEHX	Hampton Inn and Suites Billings West I-90, MT
BIMBRHH	Hilton at Resorts World Bimini+++
BISMKHX	Hampton Inn Bismarck, ND
BISNWHX	Hampton Inn and Suites Bismarck/Northwest, ND
BIXDTDT	DoubleTree by Hilton Biloxi
BJIMNHX	Hampton Inn and Suites Bemidji
BJXSGHX	Hampton Inn Silao, Guanajuato, Mexico
BKKCICI	Conrad Bangkok
BKKHITW	Millennium Hilton Bangkok
BKKHPHI	Hilton Pattaya
BKKRECI	Conrad Bangkok Residences
BKKSSDI	DoubleTree by Hilton Sukhumvit Bangkok
BKKSUHI	Hilton Sukhumvit Bangkok
BKRAPHX	Hampton Inn and Suites Bakersfield North/Airport, CA
BKRCAHX	Hampton Inn Bakersfield
BKRHSHX	Hampton Inn and Suites Barstow
BKRHWHW	Homewood Suites by Hilton Bakersfield
BKVMSHX	Hampton Inn Brookhaven
BKXSDHX	Hampton Inn and Suites Brookings, SD
BLAPAHX	Hampton Inn and Suites Blairsville, PA
BLINWHT	Home2 Suites by Hilton Bellingham Airport
BLKBLTW	Hilton Blackpool
BLLWAHX	Hampton Inn Bellingham-Airport, WA
BLMPAHX	Hampton Inn and Suites Bethlehem
BLOPAHX	Hampton Inn Bloomsburg
BLRORDI	DoubleTree Suites by Hilton Bangalore
BLRREHI	Hilton Bangalore Embassy GolfLinks
BLXMSHX	Hampton Inn Biloxi Beach Boulevard
BLXOSHX	Hampton Inn Biloxi Ocean Springs
BMCNMHX	Hampton Inn Brigham City, UT
BMGHWHW	Homewood Suites by Hilton Bloomington
BMGINGI	Hilton Garden Inn Bloomington, IN
BMGWLHX	Hampton Inn Bloomington
BMIDTDT	DoubleTree by Hilton Bloomington
BMINLHX	Hampton Inn and Suites Bloomington/Normal, IL
BMIWEHX	Hampton Inn Bloomington West
BMNGAHX	Hampton Inn Bremen/Carrollton
BNAANGI	Hilton Garden Inn Nashville Airport
BNAAPHT	Home2 Suites by Hilton Nashville-Airport, TN
BNABDHX	Hampton Inn Nashville/Brentwood
BNABGGI	Hilton Garden Inn Bowling Green,KY
BNABTHW	Homewood Suites by Hilton Nashville/Brentwood
BNABWHF	Hilton Suites Brentwood
BNACKHX	Hampton Inn Cookeville, TN
BNACSGI	Hilton Garden Inn Nashville/Franklin Cool Springs, TN
BNACVGI	Hilton Garden Inn Clarksville, TN
BNADTHX	Hampton Inn & Suites Nashville-Downtown
BNADUDT	DoubleTree by Hilton Nashville
BNADWHW	Homewood Suites by Hilton Nashville-Downtown, TN
BNAEAHX	Hampton Inn Nashville/Hickory Hollow
BNAEBDT	DoubleTree Suites by Hilton Nashville Airport
BNAESES	Embassy Suites by Hilton Nashville Vanderbilt University
BNAFKHX	Hampton Inn and Suites Nashville-Franklin
BNAFLES	Embassy Suites by Hilton Nashville - South-Cool Springs
BNAGDHX	Hampton Inn Nashville/Goodlettsville
BNAGHHX	Hampton Inn and Suites Nashville/Green Hills
BNAHSHX	Hampton Inn and Suites Nashville Airport
BNAHTHT	Home2 Suites by Hilton Nashville Vanderbilt, TN
BNAHWHW	Homewood Suites by Hilton Nashville Airport
BNAMTHX	Hampton Inn Mt. Juliet, TN
BNAMUGI	Hilton Garden Inn Murfreesboro, TN
BNANAES	Embassy Suites by Hilton Nashville-Airport
BNANSHF	Hilton Nashville-Downtown
BNANVGI	Hilton Garden Inn Nashville/Vanderbilt, TN
BNAOPHX	Hampton Inn and Suites Nashville at Opryland, TN
BNAUVHX	Hampton Inn and Suites Nashville-Vanderbilt/Elliston Pl, TN
BNAVBHW	Homewood Suites by Hilton Nashville Vanderbilt, TN
BNAVNHX	Hampton Inn Nashville/Vanderbilt
BNAWEHX	Hampton Inn Nashville/Bellevue
BNGHSHX	Hampton Inn and Suites Banning
BNJHIHI	Hilton Bonn
BNTDTDT	DoubleTree Suites by Hilton Bentonville
BNTHWHW	Homewood Suites by Hilton Bentonville/Rogers, AR
BNTRGHX	Hampton Inn Bentonville
BOGBCHH	Hilton Bogota, CO
BOGCODT	Doubletree by Hilton Bogotá - Calle 100, Colombia
BOGNTDT	DoubleTree by Hilton Bogota Parque 93
BOHCCHX	Hampton by Hilton Bournemouth
BOHTMHI	Hilton Bournemouth, UK
BOIDNHX	Hampton Inn and Suites Boise-Downtown, ID
BOIEHGI	Hilton Garden Inn Boise/Eagle, ID
BOIGIGI	Hilton Garden Inn Boise Spectrum
BOIHSHX	Hampton Inn and Suites Boise/Meridian
BOIHWHW	Homewood Suites by Hilton Boise, ID
BOIIDHX	Hampton Inn Boise-Airport, ID
BOISPHX	Hampton Inn and Suites Boise/Spectrum, ID
BOMAPHI	Hilton Mumbai International Airport
BOSANHW	Homewood Suites by Hilton Boston/Andover, MA
BOSAPES	Embassy Suites by Hilton Boston At Logan Airport
BOSARHW	Homewood Suites by Hilton Boston/Cambridge-Arlington, MA
BOSBFDT	DoubleTree by Hilton Boston/Bedford Glen
BOSBHHH	Hilton Boston Back Bay
BOSBIHX	Hampton Inn Boston Bedford Burlington
BOSBLHW	Homewood Suites by Hilton BOS/Billerica-Bedford-Burlington
BOSBTHX	Hampton Inn Boston/Braintree
BOSBUGI	Hilton Garden Inn Boston/Burlington
BOSBWHF	Hilton Boston/Woburn
BOSCBHX	Hampton Inn Boston/Cambridge
BOSCHDT	DoubleTree Club by Hilton Boston-Bayside
BOSCNHW	Homewood Suites by Hilton Boston/Canton, MA
BOSCODT	DoubleTree by Hilton Boston-Downtown
BOSFDHF	Hilton Boston Financial District
BOSHHHX	Hampton Inn Marlborough
BOSHSHX	Hampton Inn Boston Crosstown
BOSHVHX	Hampton Inn Haverhill, MA
BOSHWHW	Homewood Suites by Hilton Boston/Peabody
BOSLAHX	Hampton Inn Boston Logan Airport
BOSLHHH	Hilton Boston Logan Airport
BOSMAES	Embassy Suites by Hilton Boston-Marlborough
BOSMFDT	DoubleTree by Hilton Boston/Milford
BOSNSDT	DoubleTree by Hilton Boston North Shore
BOSNTHX	Hampton Inn Boston/Natick
BOSNWHX	Hampton Inn Boston/Norwood, MA
BOSORDT	Doubletree by Hilton Boston - Andover, MA
BOSPBHX	Hampton Inn Boston-Peabody,MA
BOSRODT	DoubleTree by Hilton Rockland, MA
BOSSBDT	DoubleTree Suites by Hilton Boston - Cambridge
BOSWAGI	Hilton Garden Inn Boston/Waltham, MA
BOSWFHX	Hampton Inn and Suites Westford/Chelmsford, MA
BOSWSES	Embassy Suites by Hilton Boston/Waltham
BOSWTDT	DoubleTree by Hilton Boston - Westborough
BOUCOHW	Homewood Suites by Hilton Boulder
BOWMDHX	Hampton Inn Bowie
BOYBHHX	Hampton Inn and Suites Boynton Beach, FL
BPIWYHX	Hampton Inn and Suites Pinedale, WY
BPNCICI	Conrad Bali
BPTGIGI	Hilton Garden Inn Beaumont
BPTHWHW	Homewood Suites by Hilton Beaumont, TX
BPTORHX	Hampton Inn Orange, TX
BPTTXHX	Hampton Inn Beaumont
BPTWIHX	Hampton Inn and Suites Winnie, TX
BRAHNHN	Hilton Bracknell
BRASATW	Hilton St Anne's Manor Bracknell
BRAVTHX	Hampton Inn BrattleBoro, VT
BRAWEHX	Hampton Inn Branson West
BRETXHX	Hampton Inn and Suites Brenham, TX
BRIDTDI	DoubleTree by Hilton Acaya Golf Resort Lecce
BRITNHX	Hampton Inn Bristol
BROHSHX	Hampton Inn and Suites Brownsville, TX
BROHWHW	Homewood Suites by Hilton Brownsville, TX
BROSPGI	Hilton Garden Inn South Padre Island
BRSBCHX	Hampton By Hilton Bristol City Center
BRSCCGI	Hilton Garden Inn Bristol City Centre
BRSDTDI	DoubleTree by Hilton Bristol South - Cadbury South
BRSNEHX	Hampton Inn Newport East
BRSRWDI	DoubleTree by Hilton Bristol City Centre
BRUGRHI	Hilton Brussels Grand Place
BRUPMHI	Hilton Brussels City
BSBHITW	Hilton Brisbane
BSHAPHN	Hilton Avisford Park, Arundel
BSHMETW	Hilton Brighton Metropole
BSTBRHN	Hilton Bristol
BSWESES	Embassy Suites by Hilton Brunswick
BSWJIHX	Hampton Inn and Suites Jekyll Island, GA
BSWVEHX	Hampton Inn and Suites Brunswick, GA
BTANYHX	Hampton Inn Batavia
BTLCWHX	Hampton Inn Coldwater, MI
BTLMIHX	Hampton Inn Battle Creek
BTMMTHX	Hampton Inn Butte
BTPNCHX	Hampton Inn Butler, PA
BTRCADT	DoubleTree by Hilton Baton Rouge
BTRCNHX	Hampton Inn Baton Rouge-I-10 & College Drive, LA
BTRCPHF	Hilton Baton Rouge Capitol Center
BTRCSES	Embassy Suites by Hilton Baton Rouge
BTRDNHX	Hampton Inn and Suites Baton Rouge/Downtown, LA
BTRDSHX	Hampton Inn Baton Rouge/Denham Springs, LA
BTREAHX	Hampton Inn and Suites Baton Rouge/I-10 East, LA
BTRGIGI	Hilton Garden Inn Baton Rouge Airport
BTRGZHX	Hampton Inn Gonzales, LA
BTRPAHX	Hampton Inn and Suites Baton Rouge/Port Allen, LA
BTSDIDI	DoubleTree by Hilton Bratislava
BTSINHX	Hampton Inn Batesville, IN
BTTVTHF	Hilton Burlington
BTVDSHW	Homewood Suites by Hilton Burlington, VT
BTVDTDT	DoubleTree by Hilton Burlington
BTVDWGI	Hilton Garden Inn Burlington-Downtown, VT
BTVGIGI	Hilton Garden Inn Bartlesville
BTVMVHX	Hampton Inn Burlington, VT
BTVOKHX	Hampton Inn Bartlesville
BTWCAHX	Hampton Inn Brentwood, CA
BTZHIHI	Hilton Bursa Convention Center and Spa
BTZHXHX	Hampton Inn Bursa
BUDHITW	Hilton Budapest
BUEBAQQ	Anselmo Buenos Aires-Curio Collection By Hilton
BUEHIHH	Hilton Buenos Aires, AR
BUFAGGI	Hilton Garden Inn Buffalo Airport
BUFAPHW	Homewood Suites by Hilton Buffalo/Airport
BUFARHX	Hampton Inn Buffalo Airport
BUFATHX	Hampton Inn and Suites Buffalo/Airport, NY
BUFDTHX	Hampton Inn and Suites Buffalo Downtown
BUFEAHX	Hampton Inn East Aurora, NY
BUFESES	Embassy Suites by Hilton Buffalo
BUFFLDT	DoubleTree by Hilton Buffalo-Amherst
BUFHWHW	Homewood Suites by Hilton Buffalo/Amherst, NY
BUFMSGI	Hilton Garden Inn Buffalo - Downtown, Ny
BUFNYDT	DoubleTree Club by Hilton Buffalo Downtown
BUFWSHX	Hampton Inn Buffalo South
BUFWVHX	Hampton Inn Williamsville
BUHDTDI	DoubleTree by Hilton Bucharest-Unirii Square
BUHHITW	Athenee Palace Hilton Bucharest
BURCAGI	Hilton Garden Inn Calabasas
BURGLES	Embassy Suites by Hilton Los Angeles Glendale
BURHGHF	Hilton Glendale
BURPDGI	Hilton Garden Inn Palmdale, CA
BURUCHF	Hilton Los Angeles-Universal City
BURWCHF	Hilton Woodland Hills/Los Angeles
BUSBTHI	Hilton Batumi
BVDNCHX	Hampton Inn Brevard
BWDTXHX	Hampton Inn Brownwood, TX
BWGKYHX	Hampton Inn Bowling Green, KY
BWIABGI	Hilton Garden Inn Aberdeen, MD
BWIAHGI	Hilton Garden Inn Baltimore Washington Airport
BWIANGI	Hilton Garden Inn Annapolis, MD
BWIAPHF	Hilton BWI Airport
BWIARGI	Hilton Garden Inn  Arundel Mills
BWIBADT	DoubleTree by Hilton Baltimore - BWI Airport
BWIBDES	Embassy Suites by Hilton Baltimore Downtown
BWICCHH	Hilton Baltimore
BWICHDT	DoubleTree by Hilton Columbia MD
BWICOGI	Hilton Garden Inn Columbia
BWICUDT	Inn at Colonnade
BWIEPHT	Home2 Suites by Hilton Baltimore Downtown, MD
BWIIHGI	Hilton Garden Inn Baltimore Inner Harbor, MD
BWIKIGI	Hilton Garden Inn Kent Island, MD
BWILMDT	DOUBLETREE BY HILTON LAUREL
BWILWDT	Doubletree By Hilton Largo/Washington DC
BWIOMGI	Hilton Garden Inn Baltimore/Owings Mills
BWIOPHT	Home2 Suites by Hilton Baltimore/Aberdeen, MD
BWIOWHX	Hampton Inn Baltimore/Owings Mills, MD
BWIWAGI	Hilton Garden Inn Waldorf, MD
BWIWMGI	Hilton Garden Inn Baltimore/White Marsh, MD
BXNBTHI	Hilton Bodrum Turkbuku Resort & Spa
BYGWYHX	Hampton Inn and Suites Buffalo, WY
BYHBLHX	Hampton Inn Blytheville, AR
BZNGIGI	Hilton Garden Inn Bozeman, MT
BZNHWHW	Homewood Suites by Hilton Bozeman, MT
BZNMTHX	Hampton Inn Bozeman
CADSMHX	Hampton Inn Cadillac, MI
CAECCHF	Hilton Columbia Center
CAECLHX	Hampton Inn and Suites Columbia I-20/Clemson Road, SC
CAECOGI	Hilton Garden Inn Columbia/Harbison
CAECSDT	DoubleTree by Hilton Columbia,SC
CAEDTHX	Hampton Inn Columbia Downtown Historic District
CAEFJHX	Hampton Inn and Suites Columbia Southeast Ft. Jackson, SC
CAEGSES	Embassy Suites by Hilton Columbia-Greystone
CAEHWHW	Homewood Suites by Hilton Columbia, SC
CAELXHX	Hampton Inn Columbia/Lexington
CAENEHX	Hampton Inn Columbia Northeast - Fort Jackson, SC
CAENOGI	Hilton Garden Inn Columbia/Northeast, SC
CAENWHX	Hampton Inn Columbia Harrison Blvd.
CAEWEHX	Hampton Inn Columbia Airport
CAICICI	Conrad Cairo
CAIPGHI	Hilton Pyramids Golf Resort
CAIRHTW	Ramses Hilton
CAIZRHI	Hilton Cairo Zamalek Residences
CAKAPGI	Hilton Garden Inn Akron-Canton Airport
CAKBMHX	Hampton Inn and Suites Canton, OH
CAKEMGI	Hilton Garden Inn Akron, OH
CAKFAHW	Homewood Suites by Hilton Akron Fairlawn, OH
CAKFLDT	DoubleTree by Hilton Akron/Fairlawn
CAKHWHF	Hilton Akron Fairlawn
CAKKTHX	Hampton Inn Kent
CAKMDHX	Hampton Inn Cleveland/Medina
CAKNAES	Embassy Suites by Hilton Akron-Canton Airport
CAKNCHT	Home2 Suites by Hilton Canton, OH
CAKOHHX	Hampton Inn Akron Fairlawn
CAKSOHX	Hampton Inn Akron South
CAKWOGI	Hilton Garden Inn Wooster
CALALHX	Hampton Inn Calera, AL
CARGAHX	Hampton Inn Carrollton
CASNCHX	Hampton Inn and Suites Cashiers/Sapphire Valley, NC
CBKKSHX	Hampton Inn Colby, KS
CBNKYHX	Hampton Inn Corbin
CCBCHHF	Hilton Cocoa Beach
CCDNHHX	Hampton Inn Concord/Bow
CCOGAHX	Hampton Inn Atlanta/Newnan
CCPMAHX	Hampton Inn Chicopee/Springfield, MA
CDAIDHX	Hampton Inn and Suites Coeur d' Alene, ID
CDGHITW	Hilton Paris Charles de Gaulle Airport
CDGTPWA	Trianon Palace Versailles, A Waldorf Astoria Hotel
CDJMXHX	Hampton Inn Ciudad Juarez Mexico
CDJVCHX	Hampton Inn Ciudad Victoria, Mexico
CEDARHX	Hampton Inn Cedar City
CEUSCHX	Hampton Inn Clemson-University Area, SC
CFDNJHW	Homewood Suites Cranford
CFLPAHX	Hampton Inn Clearfield, PA
CFORDHX	Hampton Inn and Suites Chadds Ford, PA
CGNHIHI	Hilton Cologne
CHACHDT	DoubleTree by Hilton Chattanooga
CHADNHX	Hampton Inn and Suites Chattanooga/Downtown, TN
CHADTGI	Hilton Garden Inn Chattanooga Downtown
CHAHAGI	Hilton Garden Inn Chattanooga/Hamilton Place
CHAHMES	Embassy Suites by Hilton Chattanooga Hamilton Place
CHAHPHX	Hampton Inn and Suites Chattanooga-Hamilton Place, TN
CHAKMHX	Hampton Inn Kimball, TN
CHALMHX	Hampton Inn Chattanooga West/Lookout Mountain, TN
CHANOHX	Hampton Inn Chattanooga-North/Ooltewah, TN
CHAPHHX	Hampton Inn Cleveland, Tennessee
CHARGHX	Hampton Inn Ringgold/Ft. Oglethorpe, GA
CHASFHX	Hampton Inn Chattanooga Airport
CHASLHW	Homewood Suites by Hilton Chattanooga
CHIAHGI	Hilton Garden Inn Addison, IL
CHIAPHX	Hampton Inn Chicago O'Hare
CHIARDT	DoubleTree by Hilton Chicago Arlington Heights
CHIASDT	DoubleTree by Hilton Chicago-Alsip
CHIAUHX	Hampton Inn and Suites Chicago/Aurora
CHIBBHX	Hampton Inn and Suites Bolingbrok, IL
CHIBHHH	Hilton Chicago Oak Brook Hills Resort & Conference Center
CHICCDT	DoubleTree by Hilton Chicago North Shore Conference Center
CHICHHH	Hilton Chicago
CHICLHX	Hampton Inn Chicago Carol Stream
CHICTGI	Hilton Garden Inn Chesterton
CHIDHHH	The Drake Hotel
CHIDMHX	Hampton Inn Chicago Downtown/Magnificent Mile,IL
CHIDNGI	Hilton Garden Inn Chicago Downtown
CHIDPHX	Hampton Inn and Suites Chicago/Deer Park, IL
CHIDTDT	DoubleTree by Hilton Chicago O'Hare Airport
CHIDWES	Embassy Suites by Hilton Chicago-Downtown
CHIFFHX	Hampton Inn and Suites Chicago St Charles
CHIFPHX	Hampton Inn Freeport, IL
CHIGNHX	Hampton Inn Elgin
CHIGUHX	Hampton Inn Chicago/Gurnee
CHIHEGI	Hilton Garden Inn Hoffman Estates
CHIHMHX	Hampton Inn and Suites Chicago/Hoffman Estates
CHIHSHX	Hampton Inn and Suites Chicago Downtown
CHIHUHW	Homewood Suites Chicago Downtown/Magnificent Mile,IL
CHIHWHW	Homewood Chicago Downtown
CHILHQQ	LondonHouse Chicago, Curio Collection by Hilton
CHILMES	Embassy Suites by Hilton Lombard
CHILSHW	Homewood Suites by Hilton Chicago-Lincolnshire
CHILYHX	Hampton Inn and Suites Libertyville, IL
CHIMAHX	Hampton Inn and Suites Chicago-South/Matteson, IL
CHIMMDT	DoubleTree by Hilton Chicago-Magnificent Mile
CHIMPHX	Hampton Inn and Suites Chicago/Mt. Prospect, IL
CHIMUDT	DoubleTree by Hilton Libertyville-Mundelein
CHIMWHX	Hampton Inn Chicago Midway
CHINAES	Embassy Suites by Hilton Chicago-Naperville
CHINBHF	Hilton Chicago-Northbrook
CHINPDT	theWit - A DoubleTree by Hilton
CHINVHX	Hampton Inn Chicago/Naperville
CHIOADT	DoubleTree by Hilton Chicago Oakbrook
CHIOBGI	Hilton Garden Inn Chicago/Oakbrook Terrace
CHIOHHH	Hilton Chicago O'Hare Airport
CHIOPHW	Homewood Suites by Hilton Orland Park, IL
CHIOTHS	Hilton Suites Chicago/Oakbrook Terrace
CHIPHHH	The Palmer House Hilton
CHIREES	Embassy Suites by Hilton Chicago Lakefront
CHIRMES	Embassy Suites by Hilton Chicago-OHare Rosemont
CHISBES	Embassy Suites by Hilton Chicago-Schaumburg-Woodfield
CHISCGI	Hilton Garden Inn St. Charles
CHISGDT	DoubleTree by Hilton Chicago/Schaumburg
CHISKHX	Hampton Inn and Suites Chicago North Shore
CHISMHW	Homewood Suites by Hilton Chicago
CHITDHX	Hampton Inn Chicago Theatre District, IL
CHITPHX	Hampton Inn Chicago/Tinley Park
CHIWAWA	Waldorf Astoria Chicago
CHIWCHX	Hampton Inn Chicago/Westchester
CHIWDDT	DoubleTree by Hilton Chicago Wood Dale/Itasca
CHIYVHX	Hampton Inn Yorkville, IL
CHKSFHX	Hampton Inn Chickasha, OK
CHLOHHX	Hampton Inn and Suites Chillicothe
CHOCHGI	Hilton Garden Inn Charlottesville
CHOCNHW	Homewood Suites by Hilton Charlottesville, VA
CHOMSHX	Hampton Inn and Suites Charlottesvile @ University
CHOSHDT	DoubleTree by Hilton Charlottesville
CHOVAHX	Hampton Inn Charlottesville
CHRKEHX	Hampton Inn Cherokee
CHSACHX	Hampton Inn Charleston Airport
CHSAHGI	Hilton Garden Inn Charleston Airport
CHSCCHT	Home2 Suites by Hilton Charleston Airport/Convention Center
CHSCODT	DoubleTree by Hilton Charleston North Convention Center
CHSCSDT	DoubleTree Suites by Hilton Charleston-Historic District
CHSDIHX	Hampton Inn Charleston/Daniel Island
CHSDWGI	Hilton Garden Inn Charleston Waterfront/Downtown
CHSEMES	Embassy Suites by Hilton North Charleston Airport
CHSESES	Embassy Suites by Hilton Charleston, S.C.
CHSHDHX	Hampton Inn Charleston Historic District
CHSHMHW	Homewood Suites by Hilton North Charleston/Airport, SC
CHSHWHW	Homewood Suites by Hilton Charleston - Mt. Pleasant
CHSMPHX	Hampton Inn and Suites Charleston/Mount Pleasant
CHSMTHX	Hampton Inn Charleston/Mount Pleasant
CHSNCDT	DoubleTree by Hilton North Charleston
CHSNOHX	Hampton Inn North Charleston
CHSPLGI	Hilton Garden Inn Mount Pleasant
CHSUBHX	Hampton Inn and Suites North Charleston/University Blvd, SC
CHSWAHX	Hampton Inn and Suites Charleston/West Ashley
CICCAHX	Hampton Inn and Suites Chino, CA
CIDCCDT	DoubleTree by Hilton Cedar Rapids Convention Complex
CIDCLHX	Hampton Inn Iowa City
CIDIAHX	Hampton Inn Cedar Rapids
CIDNOHW	Homewood Suites by Hilton Cedar Rapids/North, IA
CIDPPHX	Hampton Inn and Suites Cedar Rapids/North, IA
CIGCOHX	Hampton Inn and Suites Craig, CO
CJCDTDT	Doubletree By Hilton Calama
CKBGIGI	Hilton Garden Inn Clarksburg
CKBWVHX	Hampton Inn Bridgeport/Clarksburg
CKVFCHT	Home2 Suites by Hilton Clarksville/Ft. Campbell, TN
CKVTNHX	Hampton Inn and Suites Clarksville, TN
CLAPAHX	Hampton Inn Clarion, PA
CLBTNHX	Hampton Inn Columbia, TN
CLDNJHX	Hampton Inn Carlstadt
CLEAHGI	Hilton Garden Inn Cleveland Airport
CLEBDHW	Homewood Suites by Hilton Cleveland-Beachwood, OH
CLEBHES	Embassy Suites by Hilton Cleveland / East Beachwood
CLEBWHX	Hampton Inn and Suites Cleveland/Beachwood, OH
CLECBDT	DoubleTree by Hilton Cleveland East/Beachwood
CLECCHX	Hampton Inn Cleveland Airport
CLECRDT	DoubleTree by Hilton Cleveland Westlake
CLEDOHH	Hilton Cleveland Downtown, OH
CLEDRHX	Hampton Inn Cleveland/Westlake
CLEDTHX	Hampton Inn Cleveland Downtown
CLEEMGI	Hilton Garden Inn Cleveland East/Mayfield Heights, OH
CLEEYHX	Hampton Elyria, OH
CLEGWGI	Hilton Garden Inn Cleveland Downtown
CLEHSDT	DoubleTree by Hilton Cleveland-South
CLEHWHW	Homewood Suites by Hilton Cleveland/Solon
CLEINES	Embassy Suites by Hilton Cleveland-Rockside
CLEIPHX	Hampton Inn and Suites Cleveland/Independence
CLELSDT	DoubleTree by Hilton Cleveland Downtown/Lakeside
CLEMEHX	Hampton Inn and Suites Cleveland/Mentor, OH
CLEMHHX	Hampton Inn and Suites Cleveland/Middleburg Heights, OH
CLESLHX	Hampton Inn Cleveland/Solon, OH
CLETHGI	Hilton Garden Inn Cleveland/Twinsburg
CLEUCDT	DoubleTree by Hilton Tudor Arms Hotel
CLIMOHX	Hampton Inn Clinton, MO
CLJHXHX	Hampton Inn Cluj Romania
CLKOKHX	Hampton Inn Clinton, OK
CLLCHHF	Hilton College Station
CLLGIGI	Hilton Garden Inn College Station, TX
CLLHTHT	Home2 Suites by Hilton College Station, TX
CLLHWHW	Homewood Suites by Hilton College Station
CLLTEHX	Hampton Inn College Station
CLLTXHX	Hampton Inn and Suites College Station
CLNNJHX	Hampton Inn Clinton
CLOHXHX	Hampton Inn Cali, Colombia
CLONMHX	Hampton Inn Clovis
CLRSSHX	Hampton Inn and Suites Childress, TX
CLTALHW	Homewood Suites by Hilton Charlotte/Ayrsley, NC
CLTAPDT	DoubleTree by Hilton Charlotte Airport
CLTATHX	Hampton Inn and Suites Charlotte-Airport, NC
CLTAYGI	Hilton Garden Inn Charlotte/Ayrsley, NC
CLTBAHW	Homewood Suites by Hilton Charlotte Ballantyne Area, NC
CLTBLHX	Hampton Inn and Suites Belmont, NC
CLTCCES	Embassy Suites by Hilton Charlotte Concord
CLTCDHX	Hampton Inn Concord/Kannapolis
CLTCOGI	Hilton Garden Inn Charlotte/Concord, NC
CLTCRHX	Hampton Inn Charlotte/Lake Norman
CLTDSHW	Homewood Suites by Hilton Davidson, NC
CLTDTDT	DoubleTree Suites by Hilton Charlotte-Southpark
CLTEPHF	Hilton Charlotte-Executive Park
CLTHHHF	Hilton Charlotte City Center
CLTHSHX	Hampton Inn and Suites Charlotte/Arrowood Road
CLTHUHF	Hilton Charlotte University Place, NC
CLTHVHX	Hampton Inn and Suites Charlotte/Huntersville, NC
CLTHWHW	Homewood Suites Charlotte-Airport, NC
CLTKGHX	Hampton Inn and Suites Charlotte @ Concord Hills
CLTLCHX	Hampton Inn Lincolnton, NC
CLTMHHX	Hampton Inn Charlotte/Matthews
CLTMOGI	Hilton Garden Inn Charlotte/Mooresville
CLTNHGI	Hilton Garden Inn Charlotte - North
CLTPHGI	Hilton Garden Inn Charlotte Pineville
CLTPKHW	Homewood Suites by Hilton Charlotte North-Univ Research
CLTRTGI	Hilton Garden Inn Charlotte Airport, NC
CLTSHHX	Hampton Inn and Suites Shelby, NC
CLTSPHX	Hampton Inn and Suites Charlotte/SouthPark @ Phillips Pl, NC
CLTTBES	Embassy Suites by Hilton Charlotte/Ayrsley
CLTTGHT	Home2 Suites by Hilton Charlotte I-77 South, NC
CLTTYES	Embassy Suites by Hilton Charlotte
CLTUPGI	Hilton Garden Inn Charlotte - Uptown
CLTUTHX	Hampton Inn Charlotte Uptown
CLTUVHX	Hampton Inn Charlotte @ University Place
CLTWCDT	DoubleTree by Hilton Charlotte-Gateway Village
CLUGBHX	Hampton Inn and Suites Greensburg, IN
CLUINGI	Hilton Garden Inn Columbus/Edinburgh, IN
CLUSMHX	Hampton Inn Seymour
CLUTVHX	Hampton Inn Columbus/Taylorsville
CLWFLHW	Homewood Suites by Hilton St. Petersburg Clearwater
CLWLGHX	Hampton Inn and Suites Largo, FL
CLWNOHX	Hampton Inn Clearwater Central
CLWPPHX	Hampton Inn and Suites Clearwater/Pinnellas
CLWPRHX	Hampton Inn and Suites Port Richey, FL
CLWPTHW	Homewood Suites by Hilton Tampa-Port Richey, FL
CMEMXHX	Hampton Inn Ciudad del Carmen Campeche, MX
CMHAPHX	Hampton Inn Columbus Airport
CMHATES	Embassy Suites by Hilton Columbus Airport
CMHCAGI	Hilton Garden Inn Columbus Airport
CMHCEES	Embassy Suites by Hilton Columbus
CMHCHHF	Hilton Columbus
CMHCPGI	Hilton Garden Inn Columbus/Polaris
CMHDHGI	Hilton Garden Inn Columbus/Dublin
CMHDLHX	Hampton Inn Columbus/Delaware
CMHDUHW	Homewood Suites by Hilton Columbus/Dublin
CMHDWHH	Hilton Columbus Downtown
CMHEAHX	Hampton Inn Columbus East
CMHESES	Embassy Suites by Hilton Columbus-Dublin
CMHETHX	Hampton Inn & Suites Columbus /Easton Area
CMHGCGI	Hilton Garden Inn Columbus/Grove City
CMHHIHW	Homewood Suites by Hilton Columbus/Hilliard
CMHHLHX	Hampton Inn and Suites Columbus/Hilliard
CMHHSHX	Hampton Inn and Suites Columbus Downtown
CMHHUHW	Homewood Suites by Hilton Columbus/Worthington
CMHLAHW	Homewood Suites by Hilton Columbus/OSU (Lane Ave), OH
CMHNEDT	DoubleTree by Hilton Newark, Ohio
CMHNWHX	Hampton Inn Columbus/Dublin
CMHPOHF	Hilton Columbus/Polaris
CMHPPHW	Homewood Suites by Hilton Columbus/Polaris, OH
CMHPSHX	Hampton Inn and Suites Columbus/Polaris, OH
CMHSBDT	DoubleTree Suites by Hilton Columbus Downtown
CMHSHHX	Hampton Inn Columbus/Hamilton Road
CMHSOHX	Hampton Inn Columbus South
CMHUAGI	Hilton Garden Inn Columbus University Area
CMHUNHX	Hampton Inn and Suites Columbus/University Area, OH
CMHWEHX	Hampton Inn Columbus West
CMHWNDT	DoubleTree by Hilton Columbus/Worthington
CMICHGI	Hilton Garden Inn Champaign/Urbana, IL
CMIHWHW	Homewood Suites by Hilton Champaign/Urbana
CMIILHX	Hampton Inn Champaign/Urbana
CNMNMHX	Hampton Inn and Suites Carlsbad, NM
CNSDCDI	DoubleTree by Hilton Cairns
CNTSCHX	Hampton Inn and Suites Clinton, SC
CNWARHX	Hampton Inn Conway
CNYMBHX	Hampton Inn Moab, UT
COBHNHN	Hilton Cobham
COIBHHX	Hampton Inn Cocoa Beach/Cape Canaveral, FL
COLHITW	Hilton Colombo
COLJTTW	Hilton Colombo Residence
COMGAHX	Hampton Inn Commerce
COMNYHX	Hampton Inn Long Island/Commack
CONCHHF	Hilton Concord
CONTNHX	Hampton Inn and Suites Tilton, NH
COSAPGI	Hilton Garden Inn Colorado Springs Airport, CO
COSCCES	Embassy Suites by Hilton Colorado Springs
COSCHGI	Hilton Garden Inn Colorado Springs
COSHHHX	Hampton Inn Colorado Springs Airport
COSHWHW	Homewood Suites by Hilton Colorado Springs Airport
COSIQHX	Hampton Inn and Suites Colorado Springs-Interquest
COSNHHX	Hampton Inn Colorado Springs Central Air Force Academy, CO
COSNOHW	Homewood Suites by Hilton Colorado Springs North
COSPDT	DoubleTree by Hilton Colorado Springs - World Arena, CO
COSWAHX	Hampton Inn and Suites Colorado Springs/World Arena, CO
COTBAHX	Hampton Inn Cotulla, TX
COUHHHX	Hampton Inn Columbia, MO
COUMHGI	Hilton Garden Inn Columbia, MO
COUTBDT	DoubleTree by Hilton Columbia - The Broadway, MO
COUUMHX	Hampton Inn and Suites Columbia (at the Univ of Missoui)
COVGIGI	Hilton Garden Inn Covington/Mandeville
COVHMHW	Homewood Suites by Hilton Covington, LA
COVLAHX	Hampton Inn Convington/Mandeville
CPHAPHI	Hilton Copenhagen Airport
CPKNYHX	Hampton Inn Clifton Park
CPRCAGI	Hilton Garden Inn Casper
CPRWYHX	Hampton Inn and Suites Casper, WY
CPTCCHI	Hilton Cape Town City Centre
CPTUEDI	DoubleTree by Hilton Cape Town - Upper Eastside Hotel
CRBILHX	Hampton Inn Carbondale
CRDHXHX	Hampton Inn and Suites Cordele, GA
CRKCOHX	Hampton Inn Castle Rock
CRNGAHX	Hampton Inn Cornelia
CRNHITW	Hilton Cairns
CROHNHN	Hilton London Croydon
CROHXHX	Hampton Inn Croydon
CRPALHX	Hampton Inn Alice, TX
CRPCCGI	Hilton Garden Inn Corpus Christi, TX
CRPHWHW	Homewood Suites by Hilton Corpus Christi
CRPKVHX	Hampton Inn Kingsville, TX
CRPPAHX	Hampton Inn and Suites Port Aransas, TX
CRPPTHX	Hampton Inn Corpus Christi/Portland
CRPSPES	Embassy Suites by Hilton Corpus Christi
CRPWEHX	Hampton Inn Corpus Christi Northwest
CRSTXHX	Hampton Inn and Suites Corsicana-I-45, TX
CRTKYHX	Hampton Inn Carrollton, KY
CRVTNHX	Hampton Inn Caryville/Cove Lake
CRWEMES	Embassy Suites by Hilton Charleston, W.V.
CRWSOHX	Hampton Inn Charleston/Southbridge
CRWWVHX	Hampton Inn Charleston Downtown. WV
CRYHSHW	Homewood Suites by Hilton Raleigh/Cary
CRYNCHX	Hampton Inn Raleigh.Cary
CSBHHHX	Hampton Inn Christiansburg/Blacksburg
CSGATHX	Hampton Inn Columbus Airport, GA
CSGBPHT	Home2 Suites by Hilton - Columbus, GA
CSGDTDT	DoubleTree by Hilton Columbus
CSGFBHX	Hampton Inn Columbus-South/Ft. Benning, GA
CSGGHGI	Hilton Garden Inn Columbus
CSGHWHW	Homewood Suites by Hilton Columbus, GA
CSGNOHX	Hampton Inn Columbus North,GA
CSGPCHX	Hampton Inn & Suites Phenix City
CSNCAHX	Hampton Inn Los Angeles/Carson
CSNHSHX	Hampton Inn and Suites Carson City, NV
CSVTNHX	Hampton Inn Crossville, TN
CTACDT	DoubleTree by Hilton Seattle Airport
CTDNYHX	Hampton Inn Cortland
CTGHIHH	Hilton Cartagena
CTGHXHX	Hampton Inn Cartagena, Colombia
CTNMSHX	Hampton Inn Canton, MS
CTSNVHI	Hilton Niseko Village
CTVGAHX	Hampton Inn Cartersville
CUMGAHX	Hampton Inn Cumming
CURHIHH	Hilton Curacao
CUUMXHX	Hampton Inn Chihuahua
CVGBAES	Embassy Suites by Hilton Cincinnati-Northeast
CVGBLHX	Hampton Inn Cincinnati/Blue Ash
CVGBOGI	Hilton Garden Inn Cincinnati/Blue Ash, OH
CVGCHHF	Hilton Cincinnati Airport
CVGCMGI	Hilton Garden Inn Cincinnati/Mason, OH
CVGCVES	Embassy Suites by Hilton Cincinnati-Rivercenter/Covington
CVGEGHX	Hampton Inn Cincinnati Eastgate
CVGFDHX	Hampton Inn Cincinnati Northwest
CVGFLHX	Hampton Inn Cincinnati Airport North
CVGFOHW	Homewood Suites by Hilton Cincinnati Airport South-Florence
CVGHBDT	DoubleTree by Hilton Cincinnati Airport
CVGHSHX	Hampton Inn and Suites Cincinnati-Union Ctr, OH
CVGKIHX	Hampton Inn Cincinnati/King's Island
CVGKRDT	DoubleTree Suites by Hilton Cincinnati-Blue Ash
CVGKYHX	Hampton Inn Cincinnati Riverfront
CVGLADT	DoubleTree by Hilton Lawrenceburg
CVGMAHW	Homewood Suites by Hilton Cincinnati Mason, OH
CVGMLHW	Homewood Suites by Hilton Cincinnati/Milford, OH
CVGMSGI	Hilton Garden Inn Cincinnati/West Chester, OH
CVGNEGI	Hilton Garden Inn Cincinatti-Northeast, OH
CVGNPHF	Hilton Cincinnati Netherlands Plaza
CVGSFHX	Hampton Inn Cincinnati Airport
CVGSHGI	Hilton Garden Inn Cincinnati/Sharonville
CVGUPHX	Hampton Inn and Suites Cincinnati/Uptown-University Area, OH
CVGVSHW	Homewood Suites by Hilton Cincinnati-Downtown
CVGWGHX	Hampton Inn and Suites Wilmington, OH
CVGWIHX	Hampton Inn and Suites Wilder, KY
CVOCHGI	Hilton Garden Inn Corvallis
CVTHNHN	Hilton Coventry
CVTRADI	DoubleTree by Hilton at the Ricoh Arena - Coventry
CVTRIHX	Hampton Inn Coventry
CWIVBHX	Hampton Inn Clinton, IA
CWLHITW	Hilton Cardiff
CXONOHX	Hampton Inn and Suites Conroe I-45 North, TX
CYDINHX	Hampton Inn Corydon
CYSWYHX	Hampton Inn Cheyenne
DABAHGI	Hilton Garden Inn Daytona Beach Airport
DABBFHX	Hampton Inn Daytona Beach/Beachfront, FL
DABDHHF	Hilton Daytona Beach Ocean Walk Village
DABFLHX	Hampton Inn Daytona Beach Shores
DABHWHW	Homewood Suites By Hilton - Daytona Beach/Speedway AP
DABNSHX	Hampton Inn New Smyrna Beach, FL
DABOBHX	Hampton Inn Daytona/Ormond Beach
DABOFGI	Hilton Garden Inn Daytona Beach Oceanfront, FL
DABPCHX	Hampton Inn and Suites Palm Coast-South, FL
DABTCGI	Hilton Garden Inn Palm Coast Town Center
DABVLHX	Hampton Inn Daytona Speedway
DACFLHX	Hampton Inn Brooksville/Dade City
DACZPHX	Hampton Inn Dade City/Zephyrhills, FL
DALADHX	Hampton Inn Dallas/Addison, TX
DALAEHW	Homewood Suites by Hilton Dallas/Allen, TX
DALAHGI	Hilton Garden Inn Dallas/Addison, TX
DALALGI	Hilton Garden Inn Dallas/Allen
DALANHX	Hampton Inn and Suites Allen, TX
DALARHW	Homewood Suites by Hilton Dallas/Arlington
DALASHW	Homewood Suites by Hilton Dallas/Addison
DALATHX	Hampton Inn and Suites Dallas/Arlington-South, TX
DALCKHX	Hampton Inn and Suites Dallas-Cockrell Hill/I-30,  TX
DALCUQQ	Highland Dallas, Curio Collection By Hilton
DALDEHX	Hampton  Dallas/Desoto
DALDUGI	Hilton Garden Inn Dallas/Duncanville
DALELHW	Homewood Suites by Hilton Dallas Downtown, TX
DALEMES	Embassy Suites by Hilton Dallas-DFW Arpt N Outdoor World, TX
DALESES	Embassy Suites by Hilton Dallas-Near the Galleria
DALETHX	Hampton Inn and Suites Dallas-Arlington No./Ballpark Way, TX
DALFBDT	DoubleTree by Hilton Dallas-Farmers Branch, TX
DALFCHX	Hampton Inn & Suites Legacy Park/Frisco TX
DALFFHX	Hampton Inn and Suites Dallas/Frisco North-Fieldhouse US, TX
DALFSES	Embassy Suites by Hilton Dallas-Frisco
DALFWES	Embassy Suites by Hilton Dallas-Market Center
DALGPHX	Hampton Inn and Suites Dallas/Grapevine
DALGVHW	Homewood Suites by Hilton Dallas-Park Central Area
DALHMHW	Homewood Suites by Hilton Dallas-Frisco, TX
DALHSHX	Hampton Inn & Suites Dallas/Mesquite
DALHTHX	Hampton Inn and Suites Dallas DFW Airport West
DALHWHW	Homewood Suites by Hilton Dallas-DFW Airport N-Grapevine
DALIRHW	Homewood Suites by Hilton Irving/DFW Airport, TX
DALLCHW	Homewood Suites by Hilton Dallas-Irving-Las Colinas
DALLEGI	Hilton Garden Inn Dallas/Lewisville, TX
DALLFES	Embassy Suites by Hilton Dallas-Love Field
DALLODT	DoubleTree by Hilton Dallas - Love Field
DALLSHX	Hampton Inn Dallas/Irving- Las Colinas
DALLWHW	Homewood Suites by Hilton Dallas/Lewisville
DALMAGI	Hilton Garden Inn Dallas Market Center
DALMCHW	Homewood Suites by Hilton Dallas Market Center
DALMKDT	DoubleTree by Hilton Dallas Market Center
DALMYHX	Hampton Inn and Suites McKinney, TX
DALPAGI	Hilton Garden Inn Dallas Downtown
DALPCHF	Hilton Dallas-Park Cities
DALPEHX	Hampton Inn and Suites Plano-East, TX
DALPGHH	Hilton Plano Granite Park
DALPLHX	Hampton Inn Plano/North Dallas
DALPOHW	Homewood Suites by Hilton Dallas-Plano
DALPPHX	Hampton Inn and Suites Dallas Market Center, TX
DALRHDT	DoubleTree by Hilton Dallas/Richardson
DALRIGI	Hilton Garden Inn Dallas/Richardson, TX
DALRKHX	Hampton Inn Dallas-Rockwall, TX
DALRWHF	Hilton Dallas/Rockwall Lakefront
DALSVHX	Hampton Inn and Suites Stephenville, TX
DALTCHW	Homewood Suites by Hilton Plano-Richardson
DALTXES	Embassy Suites by Hilton Dallas-Park Central Area
DALVRHX	Hampton Inn and Suites Dallas-Lewisville/Vista Ridge Mall, T
DALVVDT	DoubleTree by Hilton Dallas Near The Galleria
DALWHHX	Hampton Inn Dallas North @ Walnut Hill
DALWXHX	Hampton Inn and Suites Waxahachie, TX
DANNCHX	Hampton Inn Eden
DANRSHX	Hampton Inn Danville
DARGAHX	Hampton Inn Darien
DAYAPHX	Hampton Inn and Suites Dayton/Airport, OH
DAYBCGI	Hilton Garden Inn Dayton/Beavercreek, OH
DAYDSGI	Hilton Garden Inn Dayton South/Austin Landing, OH
DAYFBHW	Homewood Suites by Hilton Dayton/Fairborn
DAYFNHX	Hampton Inn Dayton/Fairborn
DAYHHHX	Hampton Inn Daytron/Huber Heights
DAYLTDT	DoubleTree by Hilton Dayton Downtown
DAYSHHX	Hampton Inn Dayton/Dayton Mall, OH
DAYSOHW	Homewood Suites by Hilton Dayton South
DAYSSDT	DoubleTree Suites by Hilton Dayton/Miamisburg
DAYVNHX	Hampton Inn and Suites Dayton/Vandalia, OH
DBLVAHX	Hampton Inn Dublin, VA
DBNGAHX	Hampton Inn Dublin, GA
DBQDTGI	Hilton Garden Inn Dubuque Downtown, IA
DBQIAHX	Hampton Inn Dubuque, IA
DBVHIHI	Hilton Imperial Dubrovnik
DCAAEDT	DoubleTree by Hilton Washington DC - Crystal City
DCAAHHF	Hilton Alexandria Mark Center
DCAARGI	Hilton Garden Inn Arlington/Courthouse Plaza, VA
DCAASGI	Hilton Garden Inn Arlington Shirlington
DCACCGI	Hilton Garden Inn Crystal City
DCACHGI	Hilton Garden Inn Washington DC Downtown
DCADGHX	Hampton Inn Dahlgren, VA
DCAFCGI	Hilton Garden Inn Falls Church
DCAFHGI	Hilton Garden Inn Fredericksburg
DCAGBGI	Hilton Garden Inn Washington DC/Greenbelt
DCALPHT	Home2 Suites by Hilton Lexington Park Patuxent River NAS, MD
DCANAHF	Hilton Crystal City at Reagan National Airport
DCANMGI	Hilton Garden Inn Washington, DC/US Capitol
DCAOLGI	Hilton Garden Inn Alexandria/Old Town
DCAOTHF	Hilton Alexandria Old Town
DCARVGI	Hilton Garden Inn Rockville-Gaithersburg
DCASFHW	Homewood Suites Springfield, VA
DCASGGI	Hilton Garden Inn Silver Spring North, MD
DCASHHH	The Capital Hilton
DCASOGI	Hilton Garden Inn Solomons, MD
DCASSDT	DoubleTree by Hilton Washington DC/Silver Spring, MD
DCASVES	Embassy Suites by Hilton Springfield, VA
DCATCGI	Hilton Garden Inn Tysons Corner
DCAVAHF	Hilton Arlington, VA
DCAWBGI	Hilton Garden Inn Woodbridge, VA
DCAWHHH	Washington Hilton
DCUATHX	Hampton Inn and Suites Athens I-65, AL
DCUHHHX	Hampton Inn Decatur
DCUSADT	DoubleTree by Hilton Decatur Riverfront
DDCTYHX	Hampton Inn and Suites Dodge City, KS
DDHDHHF	Hilton Boston-Dedham
DEBFLHX	Hampton Inn Debary/Deltona
DECFOHW	Homewood Suites by Hilton Decatur/Forsyth, IL
DECFRHX	Hampton Inn Decatur/Forsyth
DEEBHHX	Hampton Boca Raton Deerfield Beach
DEEFLES	Embassy Suites by Hilton Deerfield Beach Resort-Boca Raton
DEFILES	Embassy Suites by Hilton Chicago-North Shore-Deerfield
DELDGDI	DoubleTree by Hilton Hotel Gurgaon - New Delhi NCR
DELGUGI	Hilton Garden Inn Gurgaon Baani
DELSKGI	Hilton Garden Inn New Delhi/Saket
DENAHGI	Hilton Garden Inn Denver Airport
DENAPHX	Hampton Inn and Suites Denver/Airport-Gateway Park, CO
DENARES	Embassy Suites by Hilton Denver Stapleton
DENCCHX	Hampton Inn and Suites Denver/Cherry Creek
DENCHDT	The Curtis - A DoubleTree by Hilton
DENCKGI	Hilton Garden Inn Cherry Creek, CO
DENCVHX	Hampton Inn and Suites Denver Downtown Convention Center, CO
DENDCHW	Homewood Suites by Hilton Denver Downtown-Convention Center
DENDDGI	Hilton Garden Inn Denver Downtown, CO
DENDSGI	Hilton Garden Inn Denver South Park Meadows Area
DENDTHX	Hampton Inn & Suites - Denver-Downtown, CO
DENESES	Embassy Suites by Hilton Denver Downtown Convention Center
DENEWDT	DoubleTree by Hilton Denver Tech
DENFMHX	Hampton Inn and Suites Fort Morgan, CO
DENGDHX	Hampton Inn Denver West
DENGWHX	Hampton Inn Denver Airport
DENHLHX	Hampton Inn and Suites Denver/Highlands Ranch, CO
DENHPES	Embassy Suites by Hilton Denver-Southeast
DENHWHW	Homewood Suites by Hilton Denver Tech Center
DENIAES	Embassy Suites by Hilton Denver-International Airport
DENIPHW	Homewood Suites by Hilton Denver-International Airport, CO
DENITDT	DoubleTree by Hilton Denver-Aurora, CO
DENLDHW	Homewood Suites by Hilton Denver West/Lakewood, CO
DENLIHW	Homewood Suites by Hilton Denver-Littleton
DENLKHX	Hampton Inn Denver Southwest/Lakewood
DENLLHT	Home2 Suites by Hilton Denver West - Federal Center, CO
DENLMHX	Hampton Inn Longmont
DENLTHX	Hampton Inn and Suites Denver-Littleton, CO
DENLVHX	Hampton Inn Boulder/Louisville
DENLWHX	Hampton Inn Denver West/Federal Center
DENNSDT	DoubleTree by Hilton Denver North/Boulder
DENPAHX	Hampton Inn and Suites Parker, CO
DENRGHX	Hampton Inn and Suites Denver/South-RidgeGate, CO
DENSNDT	DoubleTree by Hilton Denver-Stapleton North, CO
DENSWGI	Hilton Garden Inn Denver/Highland Ranch
DENTCES	Embassy Suites by Hilton Denver Tech Center
DENTHHX	Hampton Inn Denver North/Thornton
DENTNDT	DoubleTree by Hilton Denver-Thornton
DENTRGI	Hilton Garden Inn Denver Tech Center, CO
DENUSHX	Hampton Inn and Suites Denver Tech Center
DENWMHX	Hampton Inn Denver/Westminister
DERDTDT	DoubleTree by Hilton Deerfield Beach/Boca Raton
DESHIHF	Hilton Sandestin Beach Golf Resort and Spa
DETAHHS	Hilton Suites Auburn Hills
DETDHGI	Hilton Garden Inn Detroit Downtown
DETHSES	Embassy Suites by Hilton Detroit-Metro Airport
DETMAGI	Hilton Garden Inn Detroit Metro Airport
DETNOGI	Hilton Garden Inn Detroit/Novi, MI
DETPHGI	Hilton Garden Inn Plymouth, MI
DETSHGI	Hilton Garden Inn Detroit Southfield
DFIOHHX	Hampton Inn Defiance, OH
DFWAHHF	Hilton DFW Lakes Executive Conference Center
DFWANHH	Hilton Anatole
DFWARGI	Hilton Garden Inn Dallas-Arlington
DFWASHX	Hampton Inn and Suites Dallas/Ft. Worth Airport South, TX
DFWCNDT	DoubleTree by Hilton Dallas-Campbell Centre
DFWDEHX	Hampton Inn and Suites Decatur, TX
DFWDFHT	Home2 Suites by Hilton Dallas-Frisco, TX
DFWDNGI	Hilton Garden Inn Denton
DFWDSGI	Hilton Garden Inn Denison/Sherman/At Texoma Event Center
DFWFRGI	Hilton Garden Inn Frisco
DFWGBGI	Hilton Garden Inn Granbury, TX
DFWGRGI	Hilton Garden Inn DFW North/Grapevine, TX
DFWINDT	DoubleTree by Hilton DFW Airport North
DFWIRGI	Hilton Garden Inn DFW Airport South
DFWLCGI	Hilton Garden Inn Las Colinas
DFWLTHH	Hilton Dallas Lincoln Centre
DFWSHES	Embassy Suites by Hilton DFW South
DFWSLHF	Hilton Dallas/Southlake Town Center
DHAAUDI	DoubleTree by Hilton Dhahran, Saudi Arabia
DHNDOGI	Hilton Garden Inn Dothan, AL
DHNHSHX	Hampton Inn and Suites Dothan, AL
DHNOZHX	Hampton Inn Ozark, AL
DICTNHX	Hampton Inn Dickson
DIYDAGI	Hilton Garden Inn Diyarbakir (Ari), Turkey
DLMHRHI	Hilton Dalaman Sarigerme Resort & Spa
DNBDHGI	Hilton Garden Inn Danbury
DNCHHHX	Hampton Inn Dunn, NC
DNDKWDI	DoubleTree by Hilton Dundee
DNNCDGI	Hilton Garden Inn Dalton, GA
DNNWSHX	Hampton Inn Dalton
DNVILHX	Hampton Inn and Suites Danville, IL
DNVPAHX	Hampton Inn Danville, PA
DOHHDHI	Hilton Doha
DOHOTDI	DoubleTree by Hilton Doha Old Town
DORPRES	Embassy Suites by Hilton Dorado Del Mar Beach
DOUGAHX	Hampton Inn Douglas
DOVDEHX	Hampton Inn Dover
DOVDPHT	Home2 Suites by Hilton Dover, DE
DOVMFHX	Hampton Inn Milford, DE
DROCOHX	Hampton Inn Durango
DROGSHW	Homewood Suites by Hilton Durango, CO
DRSHITW	Hilton Dresden
DRTUVHX	Hampton Inn Uvalde,TX
DRWDDDI	DoubleTree by Hilton Darwin
DRWEDDI	DoubleTree by Hilton Esplanade Darwin, NT
DRWHDHI	Hilton Darwin
DRYKYHX	Hampton Inn Dry Ridge
DSASHHX	Hampton By Hilton Sheffield
DSIESES	Embassy Suites by Hilton Destin - Miramar Beach
DSIHSHX	Hampton Inn and Suites Destin/Sandestin Area, FL
DSINEHX	Hampton Inn and Suites Destin, FL
DSMAKHX	Hampton Inn and Suites Ankeny, Iowa
DSMANHW	Homewood Suites by Hilton Ankeny, IA
DSMAPHX	Hampton Inn Des Moines Airport
DSMDNES	Embassy Suites by Hilton Des Moines Downtown
DSMFDDT	DoubleTree by Hilton Des Moines Airport
DSMUHGI	Hilton Garden Inn Des Moines/Urbandale
DSMWEHX	Hampton Inn Des Moines West
DSMWHGI	Hilton Garden Inn West Des Moines
DSMWSHX	Hampton Inn and Suites Des Moines Downtown, IA
DSTODT	DoubleTree by Hilton Modesto
DTNTXHX	Hampton Inn and Suites Denton
DTTAUHX	Hampton Inn Detroit/Auburn Hills South,MI
DTTBVHX	Hampton inn Detroit/Belleville Airport
DTTCFHX	Hampton Inn and Suites Detroit/Chesterfield Township, MI
DTTCNHX	Hampton Inn and Suites Detroit/Canton, MI
DTTDBDT	DoubleTree by Hilton Dearborn
DTTLFDT	DoubleTree Suites by Hilton Detroit Downtown - Fort Shelby
DTTLIES	Embassy Suites by Hilton Detroit-Livonia-Novi
DTTMHHX	Hampton Inn Detroit/Madison Heights
DTTNAHX	Hampton Inn Detroit/Auburn Hills-North, MI
DTTNIHX	Hampton Inn Detriot/Novi, MI
DTTNVHX	Hampton Inn Detroit/Northville
DTTRMHX	Hampton Inn & Suites Detroit/airport-Romulus,MI
DTTRVHX	Hampton Inn Detroit/Roseville, MI
DTTSFES	Embassy Suites by Hilton Detroit - Southfield
DTTSHHX	Hampton Inn and Suites Detroit/Sterling Height
DTTSTHX	Hampton Inn Detroit/Utica-Shelby Township, MI
DTTTRES	Embassy Suites by Hilton Detroit - North-Troy
DTTTYHW	Homewood Suites by Hilton Detroit-Troy
DTWNVDT	DoubleTree by Hilton Detroit/Novi
DTWSGHX	Hampton Inn Detroit/Southgate, MI
DUAOKHX	Hampton Inn and Suites Durant, OK
DUBAPHI	Hilton Dublin Airport
DUBBUDI	DoubleTree by Hilton Dublin - Burlington Road
DUBDUHN	Hilton Dublin
DUBHCCI	Conrad Dublin
DUBKMHI	Hilton Dublin Kilmainham
DUBTMDI	The Morrison Dublin, a DoubleTree by Hilton Hotel
DUJIDHW	Homewood Suites by Hilton - DuBois, PA
DUJPAHX	Hampton Inn DuBois, PA
DULMNHX	Hampton Inn Duluth
DURHITW	Hilton Durban
DUSHITW	Hilton Dusseldorf
DVKKYHX	Hampton Inn Danville, KY
DVLNJHX	Hampton Inn Denville/Rockaway/Parsippany, NJ
DVNPTHX	Hampton Inn and Suites Davenport, IA
DWDSDHX	Hampton Inn Deadwood
DXBABDI	DoubleTree by Hilton Hotel & Residences Dubai - Al Barsha
DXBAMGI	Hilton Garden Inn Dubai Al Mina, United Arab Emirates
DXBBRHI	Hilton Dubai The Walk
DXBCDCI	Conrad Dubai
DXBDCHI	Hilton Dubai Creek
DXBGIGI	Hilton Garden Inn Dubai Al Muraqabat
DXBJBHI	Hilton Dubai Jumeirah Resort
DXBMEGI	Hilton Garden Inn Dubai Mall, UAE
DXBPDWA	Waldorf Astoria Dubai Palm Jumeirah
DXBTHDI	DoubleTree by Hilton Dubai - Jumeirah Beach
DXRCTHX	Hampton Inn Danbury, CT
DYETNHX	Hampton Inn Dytersburg
DYLPAHX	Hampton Inn Doylestown, PA
EARTSHX	Hampton Inn Kearney, NE
EASPAHX	Hampton Inn Easton
EAUCRHX	Hampton Inn Eau Claire
ECGNCHX	Hampton Inn Elizabeth City
EDIAPHN	Hilton Edinburgh Airport
EDICCDI	DoubleTree by Hilton Edinburgh City Centre, UK
EDIDHHN	Hilton Dunkeld House
EDIDUDI	DoubleTree by Hilton Dunblane Hydro
EDIQCDI	The Queensferry Hotel
EDNCHWA	Waldorf Astoria Edinburgh - The Caledonian
EDNGRHN	Hilton Edinburgh Grosvenor
EDNNCHX	Hampton Inn Edenton
EFFKDHX	Hampton Inn and Suites Effingham, IL
EHTCTHX	Hampton Inn and Suites Hartford/East Hartford, CT
EKHINHX	Hampton Inn Elkhart
EKIEDGI	Hilton Garden Inn Elkhart, IN
EKIMYHX	Hampton Inn and Suites Middlebury, IN
EKNWVHX	Hampton Inn Elkins, WV
EKOEHGI	Hilton Garden Inn Elko
EKYRCHX	Hampton Inn and Suites Radcliff/Fort Knox, KY
ELDARHX	Hampton Inn El Dorado, Ar
ELIKYHX	Hampton Inn Elizabethtown
ELKCYHX	Hampton Inn and Suites Elk City, OK
ELKMDHX	Hampton Inn Elkton
ELMGIGI	Hilton Garden Inn Elmira/Corning
ELMHHHX	Hampton Inn Elmira, NY
ELMMFHX	Hampton Inn and Suites Mansfield, PA
ELMNYHX	Hampton Inn White Plaines/Tarrytown
ELMPPHX	Hampton Inn Corning/Painted Post, NY
ELPDWDT	DoubleTree by Hilton El Paso Downtown/City Center
ELPELGI	Hilton Garden Inn El Paso Airport, TX
ELPGDHX	Hampton Inn & Suites El Paso-East, TX
ELPGIGI	Hilton Garden Inn El Paso/University
ELPGWES	Embassy Suites by Hilton El Paso
ELPHSHX	Hampton Inn and Suites El Paso Airport
ELPHWHW	Homewood Suites by Hilton El Paso-Airport, TX
ELPWEHX	Hampton Inn and Suites El Paso-West, TX
EMABTHI	Hilton at St George's Park, Burton Upon Trent
EMAHNHN	Hilton East Midlands Airport
EMALEHN	Hilton Leicester
EMANOHN	Hilton Nottingham
EMANUDI	DoubleTree by Hilton Nottingham - Gateway
EMVWEHX	Hampton Inn Emporia, VA
ENFLDHX	Hampton Inn Enfield, CT
EOKIAHX	Hampton Inn Keokuk, IA
EPHPAHX	Hampton Inn and Suites Ephrata, PA
ERCGIGI	Hilton Garden Inn Erzincan
ERIASHX	Hampton Inn Ashtabula
ERIGIGI	Hilton Garden Inn Erie, PA
ERIHHHX	Hampton Inn Erie South
ERIHTHT	Home2 Suites by Hilton Erie, PA
ERIHWHW	Homewood Suites by Hilton Erie
ESKGIGI	Hilton Garden Inn Kutahya
ESPBVHX	Hampton Inn and Suites Bartonsville, PA
ETBWBHX	Hampton Inn and Suites West Bend, WI
ETSALHX	Hampton Inn Enterprise, AL
EUGEHHF	Hilton Eugene
EUGHHHX	Hampton Inn Eugene
EUGORGI	Hilton Garden Inn Eugene/Springfield
EVVAPHX	Hampton Inn Evansville/Airport, IN
EVVEVGI	Hilton Garden Inn Evansville, IN
EVVINHX	Hampton Inn Evansville, IN
EVWWYHX	Hampton Inn Evanston, WY
EWBFHHX	Hampton Inn New Bedford/Fairhaven
EWNMSDT	DoubleTree by Hilton New Bern
EWRAHHH	Hilton Newark Airport
EWRBHHF	Hilton East Brunswick
EWRBRGI	Hilton Garden Inn Bridgewater
EWRDADT	DoubleTree by Hilton Somerset
EWRELES	Embassy Suites by Hilton Newark Airport
EWRETHW	Homewood Suites by Hilton Eatontown, NJ
EWREWHW	Homewood Suites by Hilton Edgewater (NYC Area), NJ
EWRHGHF	Hilton Newark-Gateway
EWRHHHF	Hilton Hasbrouck Heights-Meadowlands
EWRLWGI	Hilton Garden Inn Lakewood, NJ
EWRMLHW	Homewood Suites by Hilton Philadelphia/Mt. Laurel
EWRNADT	DoubleTree by Hilton Newark Airport
EWRNBHX	Hampton Inn North Brunswick/New Brunswick, NJ
EWRPHHF	Hilton Parsippany
EWRRCGI	Hilton Garden Inn Edison/Raritan Center
EWRROGI	Hilton Garden Inn Rockaway
EWRRYHT	Home2 Suites by Hilton Rahway, NJ
EWRSCGI	Hilton Garden Inn Secaucus/Meadowlands
EWRSHHH	Hilton Short Hills
EWRSIGI	Hilton Garden Inn New York/Staten Island
EWRSMHF	Hilton Meadowlands
EWRWTDT	DoubleTree by Hilton Jersey City
EXTAPHX	Hampton Inn Exeter Airport
EYPYOHX	Hampton Inn Yopal, Colombia
EYWCMWA	Casa Marina Resort, FL
EYWDTDT	DoubleTree by Hilton Key West-Grand Key Resort
EYWROGI	Hilton Garden Inn Key West/The Keys Collection, FL
EYWRRWA	The Reach Resort, FL
FAEBHGI	Hilton Garden Inn Bentonville
FAIAKHX	Hampton Inn and Suites Fairbanks, AK
FAMMOHX	Hampton Inn Farmington, MO
FAOAPCI	Conrad Algarve
FAOHIHI	Hilton Vilamoura As Cascatas Golf Resort & Spa
FARGIGI	Hilton Garden Inn Fargo
FARGOHX	Hampton Inn and Suites Fargo, ND
FARHTHT	Home2 Suites by Hilton Fargo, ND
FARHWHW	Homewood Suites by Hilton Fargo, ND
FATCAHX	Hampton Inn and Suites Fresno
FATCCDT	DoubleTree by Hilton Fresno Convention Center
FATCLHX	Hampton Inn & Suites Clovis Airport North
FATCSGI	Hilton Garden Inn Clovis, CA
FATCVHW	Homewood Suites Fresno Airport / Clovis, CA
FATHWHW	Homewood Suites by Hilton Fresno, CA
FATMDHX	Hampton Inn and Suites Madera, CA
FATWHHX	Hampton Inn and Suites Fresno-Northwest CA
FAYCCHX	Hampton Inn Fayetteville Cross Creek Mall
FAYDTDT	DoubleTree by Hilton Fayetteville
FAYFBES	Embassy Suites by Hilton Fayetteville/Fort Bragg
FAYHITW	Hilton Sharm El Sheikh Fayrouz Resort
FAYNCHX	Hampton Inn Fayetteville, NC
FAYNHGI	Hilton Garden Inn Fayetteville/Fort Bragg
FAYSDHT	Home2 Suites by Hilton Fayetteville, NC
FAYSLHX	Hampton Inn and Suites Spring Lake, NC
FBGMDHX	Hampton Inn Frostburg
FBGTXHX	Hampton Inn and Suites Fredericksburg, TX
FCAKSGI	Hilton Garden Inn Kalispell, MT
FCAMTHX	Hampton Inn Kalispell
FCLCOHX	Hampton Inn Ft. Collins
FCLHWHW	Homewood Suites By Hilton Fort Collins+++
FCYARHX	Hampton Inn Forrest City
FDRHSHX	Hampton Inn and Suites Frederick/Ft. Detrick, MD
FDRMDHX	Hampton Inn Frederick, MD
FDYEXGI	Hilton Garden Inn Findlay, OH
FDYOHHX	Hampton Inn Findlay
FFCVAHX	Hampton Inn Fairfax City
FFDNJHX	Hampton Inn and Suites Fairfield
FFTKYHX	Hampton Inn Frankfort
FHKNYHX	Hampton Inn Fishkill
FHUAZHX	Hampton Inn Sierra Vista, AZ
FKLKYHX	Hampton Inn Franklin
FKTHWHW	Homewood Suites by Hilton Somerset, NJ
FLCALHX	Hampton Inn Florence/Midtown
FLCHSHX	Hampton Inn and Suites Florence-Downtown, AL
FLGESES	Embassy Suites by Hilton Flagstaff
FLGFHGI	Hilton Garden Inn Flagstaff
FLGSDHX	Hampton Inn Sedona
FLGSSDT	DoubleTree by Hilton Flagstaff
FLGWEHX	Hampton Inn and Suites Flagstaff West
FLLANHX	Hampton Inn Ft. Lauderdale Airport North
FLLAPHX	Hampton Inn and Suites Ft. Lauderdale Airport/Hollywood
FLLARHW	Homewood Ft. Lauderdale Airport/Cruiseport
FLLBMDT	Bahia Mar-Fort Lauderdale-A DoubleTree by Hilton
FLLCCHX	Hampton Inn and Suites Coconut Creek, FL
FLLCICI	CONRAD FORT LAUDERDALE
FLLCYHX	Hampton Inn Ft. Lauderdale/Cypress Creek
FLLDHQQ	The Diplomat Resort & Spa Hollywood
FLLDNHX	Hampton Inn Ft. Lauderdale City Center
FLLFHGI	Hilton Garden Inn Ft. Lauderdale Hollywood Airport
FLLFSHH	Hilton Fort Lauderdale Beach Resort
FLLGRHH	Hilton Fort Lauderdale Marina
FLLHDHX	Hampton Inn Hallandale Beach/Aventura
FLLMMHX	Hampton Inn & Suites Fort Lauderdale/Miramar
FLLPTHX	Hampton Inn Ft. Lauderdale/Plantation
FLLSMDT	DoubleTree by Hilton Sunrise-Sawgrass Mills
FLLSOES	Embassy Suites by Hilton Ft Lauderdale-17Th Street
FLLSWGI	Hilton Garden Inn Ft. Lauderdale SW/Miramar
FLLTAHX	Hampton Inn and Suites Ft. Lauderdale/Tamarac West, FL
FLLTMHX	Hampton Inn Ft. Lauderdale Commercial Blvd.
FLLTSDT	GALLERYone - a DoubleTree Suites by Hilton Hotel
FLLWEHX	Hampton Inn Ft. Lauderdale West
FLOWJHT	Home2 Suites by Hilton Florence, SC
FLRHFHI	Hilton Florence Metropole
FLRNVGI	Hilton Garden Inn Florence Novoli
FLRWPHX	Hampton Inn Fall River/Westport
FLVRBHX	Hampton Inn Vero Beach
FMYAPHX	Hampton Inn Ft. Myers Airport
FMYARHW	Homewood Suites Fort Myers Airport
FMYCCHX	Hampton Inn and Suites Cape Coral, FL
FMYCLHX	Hampton Inn and Suites Ft. Myers-Colonial Road, FL
FMYESES	Embassy Suites by Hilton Fort Myers
FMYETHX	Hampton Inn and Suites Ft. Myers/Estero, FL
FMYHSHX	Hampton Inn and Suites Fort Myers Beach/Sanibel Gateway, FL
FMYHWHW	Homewood Suites Fort Myers
FNLCOHF	Hilton Fort Collins
FNLESES	Embassy Suites by Hilton Loveland Hotel
FNLFCGI	Hilton Garden Inn Ft. Collins, CO
FNLLDHX	Hampton Inn Loveland
FNTGBHX	Hampton Inn Flint/Grand Blanc
FPAALHX	Hampton Inn Ft. Payne, AL
FRAAPGI	Hilton Garden Inn Frankfurt Airport
FRACCHX	Hampton By Hilton Frankfurt Centre Messe
FRAHAHI	Hilton Frankfurt Airport
FRAHITW	Hilton Frankfurt City Centre+++
FRBCBHX	Hampton Inn and Suites Fredericksburg, VA
FRBHSHX	Hampton Inn and Suites Fredericksburg-South, VA
FRBHWHW	Homewood Suites by Hilton Fredericksburg, VA
FRBSFHX	Hampton Inn Stafford & Conference Center
FREOHHX	Hampton Inn Fremont, OH
FRKMAHX	Hampton Inn Franklin/Milford
FRMMNHX	Hampton Inn Fairmont, MN
FSDDWGI	Hilton Garden Inn - Sioux Falls Downtown, SD
FSDHHHX	Hampton Inn Sioux Falls
FSDHWHW	Homewood Suites by Hilton Sioux Falls
FSDMCHT	Home2 Suites by Hilton Sioux Falls/Sanford Medical Ctr
FSDNOHX	Hampton Inn North Sioux City
FSDSFGI	Hilton Garden Inn Sioux Falls South, SD
FSMARHX	Hampton Inn Ft. Smith
FSMCLHX	Hampton Inn Clarksville, AR
FSMPSHW	Homewood Suites by Hilton Ft. Smith, AR
FSMVBHX	Hampton Inn Van Buren, AR
FSTPCHX	Hampton Inn Pecos, TX
FSTTXHX	Hampton Inn Ft.Stockton, TX
FTLFLDT	DoubleTree by Hilton Fort Lee George Washington Bridge
FTPHSHX	Hampton Inn and Suites Ft. Pierce
FTRYLHX	Hampton Inn Front Royal
FTWAAGI	Hilton Garden Inn Fort Worth Alliance Airport, TX
FTWBFHW	Homewood Suites by Hilton Ft. Worth/Bedford
FTWBRHX	Hampton Inn and Suites Ft. Worth/Burleson, TX
FTWCLHX	Hampton Inn and Suites Cleburne, TX
FTWDEHW	Homewood Suites by Hilton Denton, TX
FTWESES	Embassy Suites by Hilton Fort Worth
FTWFCHX	Hampton Inn and Suites Ft. Worth-Fossil Creek, TX
FTWFHHX	Hampton Inn and Suites Fort Worth/Forest Hill, TX
FTWFWHF	Hilton Fort Worth
FTWHSHX	Hampton Inn and Suites Ft. Worth Alliance Airport
FTWHWHW	Homewood Suites by Hilton - Ft. Worth North
FTWMCHW	Homewood Suites by Hilton Fort Worth-Medical Center, TX
FTWMDGI	Hilton Garden Inn Fort Worth/Medical Center, TX
FTWMFHX	Hampton Inn and Suites Mansfield, TX
FTWNHGI	Hilton Garden Inn Fort Worth/Fossil Creek
FTWRRHX	Hampton Inn Ft. Worth Southwest
FTWSOHW	Homewood Suites by Hilton Fort Worth West Cityview, TX
FTWTCHX	Hampton Inn and Suites Trophy Club, TX
FTWWTHX	Hampton Inn and Suites Ft. Worth-West/I-30, TX
FUKHIHI	Hilton Fukuoka Sea Hawk
FWAABHX	Hampton Inn Auburn, IN
FWADPHX	Hampton Inn Ft. Wayne/Dupont Road, IN
FWAFEGI	Hilton Garden Inn Fort Wayne
FWAFHHF	Hilton Ft. Wayne
FWAINHW	Homewood Suites by Hilton Fort Wayne, IN
FWANOHX	Hampton Inn and Suites Ft. Wayne North
FWASWHX	Hampton Inn Ft. Wayne Southwest
FWBHHHX	Hampton Inn Ft. Walton Beach
FYMTNHX	Hampton Inn Fayetteville, TN
FYVARHX	Hampton Inn Fayetteville
FYVDTDT	DoubleTree Club by Hilton Springdale
FYVGIGI	Hilton Garden Inn Fayetteville, AR
FYVSPHX	Hampton Inn and Suites Springdale
FYVSSHX	Hampton Inn Siloam Springs, AR
FYVWDHW	Homewood Suites by Hilton Fayetteville, AR
GADALHX	Hampton Inn Gadsden
GADATHX	Hampton Inn and Suites Gadsden-West/Attala I-59, AL
GAFSCHX	Hampton Inn Gaffney
GAIGHHF	Hilton Washington DC North-Gaithersburg
GAIMDHX	Hampton Inn and Suites Washington, DC North/Gaithersburg, MD
GAINGHW	Homewood Suites by Hilton Gaithersburg/Washington DC North
GALTNHX	Hampton Inn Gallatin
GATDBHN	Hilton Dartford Bridge
GATHITW	Hilton London Gatwick Airport
GATMAHN	Hilton Maidstone
GBGPAHX	Hampton Inn Greensburg
GCKKSHX	Hampton Inn Garden City, KS
GCYPAHX	Hampton Inn and Suites Grove City, PA
GDLEXHX	Hampton Inn Guadalajara/Expo, Mexico
GDLGHHF	Hilton Guadalajara
GDLHAHX	Hampton Inn Guadalajara, Mexico
GDNAPHX	Hampton by Hilton Gdansk Airport
GDNHGHI	Hilton Gdansk
GEGSPGI	Hilton Garden inn Spokane Airport
GEGVYHX	Hampton Inn and Suites Spokane Valley, WA
GETPAHX	Hampton Inn Gettysburg
GEVTXHX	Hampton Inn and Suites Greenville, TX
GFDHHHX	Hampton Inn Greenfield, IN
GFIMAHX	Hampton Inn and Suites Greenfield, MA
GFKGHGI	Hilton Garden Inn Grand Forks/UND
GFKHXHX	Hampton Inn and Suites Grand Forks, ND
GGGHWHW	Homewood Suites by Hilton Longview
GGGKIHX	Hampton Inn Kilgore, TX
GGGNOHX	Hampton Inn and Suites Longview
GILWYHX	Hampton Inn Gillette
GJTCOHX	Hampton Inn Grand Junction
GJTDTDT	DoubleTree by Hilton Grand Junction
GKTPVDT	The Park Vista Gatlinburg - A DoubleTree by Hilton
GLACCGI	Hilton Garden Inn Glasgow City Centre
GLAGCHX	Hampton Inn Glasgow, United Kingdom
GLAGRHN	Hilton Glasgow Grosvenor
GLAHITW	Hilton Glasgow
GLASTHN	Hilton Strathclyde
GLRMIHX	Hampton Inn Gaylord
GLSDTDT	DoubleTree by Hilton Galveston Beach
GLSGIHF	Hilton Galveston Island
GLSHSHX	Hampton Inn and Suites Galveston, TX
GLXVAHX	Hampton Inn Galax, VA
GNVFLHX	Hampton Inn Gainesville
GNVGFGI	Hilton Garden Inn Gainesville, FL
GNVHWHW	Homewood Suites by Hilton Gainesville, FL
GOIABDI	DoubleTree by Hilton Goa-Arpora-Baga
GOJNNHX	Hampton Inn Nizhny Novgorod Gorkogo Russian Federation
GONCTHX	Hampton Inn Groton
GONNLGI	Hilton Garden Inn Mystic/Groton
GONPFGI	Hilton Garden Inn Preston Casino Area, CT
GPLOHHX	Hampton Inn Gallipolis, OH
GPTAPGI	Hilton Garden Inn Gulfport Airport
GPTDVHT	Home2 Suites by Hilton Biloxi North/D'Iberville, MS
GPTMSHX	Hampton Inn and Suites Gulfport, MS
GRBGHGI	Hilton Garden Inn Green Bay
GRBHXHX	Hampton Inn Green Bay Downtown, Wi
GRBWIHX	Hampton Inn Green Bay
GRDLRHX	Hampton Inn Greenwood
GREALHX	Hampton Inn Greenville, AL
GRINEHX	Hampton Inn Grand Island, NE
GRJPRCI	Conrad Pezula Resort and Spa
GROJPDI	DoubleTree by Hilton Girona, Spain
GRRAIDT	DoubleTree by Hilton Grand Rapids Airport
GRRAPHX	Hampton Inn Grand Rapids North
GRRHLDT	DoubleTree by Hilton Holland
GRRHSHX	Hampton Inn and Suites Grand Rapids, MI
GRRMIHW	Homewood Suites by Hilton Grand Rapids
GRRSOHX	Hampton Inn Grand Rapids South
GRVTNHX	Hampton Inn Greeneville, TN
GRVWYHX	Hampton Inn and Suites Green River, WY
GSBNCHX	Hampton Inn Goldsboro
GSOAPHX	Hampton Inn Greensboro Airport
GSOBLHX	Hampton Inn and Suites Burlington, NC
GSOEAHX	Hampton Inn Greensboro East
GSOFSHX	Hampton Inn and Suites Greensboro/Coliseum Area, NC
GSOGBES	Embassy Suites by Hilton Greensboro-Airport
GSOGRGI	Hilton Garden Inn Greensboro, NC
GSOHTHT	Home2 Suites by Hilton Greensboro Airport, NC
GSOHWHW	Homewood Suites by Hilton Greensboro
GSPCPHW	Homewood Suites by Hilton Greenville, SC
GSPDTHX	Hampton Inn and Suites Greenville-Downtown, SC
GSPELHX	Hampton Inn Easley, SC
GSPESES	Embassy Suites by Hilton Greenville Golf Resort & Conf Ctr
GSPGHHX	Hampton Inn Greenville Haywood, SC
GSPGVGI	Hilton Garden Inn Greenville
GSPHPDT	DoubleTree by Hilton Greensboro
GSPHSHX	Hampton Inn and Suites Greenville/Duncan
GSPODHX	Hampton Inn and Suites Lavonia, GA
GSPSCHF	Hilton Greenville And Towers
GSPSEHX	Hampton Inn and Suites Seneca, SC
GSPSMHX	Hampton Inn Greenville/Simpsonville
GSPTRHX	Hampton Inn Travelers Rest
GSPWDHX	Hampton Inn Greenville Woodruff Road
GSTNCHX	Hampton Inn Charlotte/Gastonia
GTFGFGI	Hilton Garden Inn Great Falls, MT
GTFMTHX	Hampton Inn Great Falls
GTNSCHX	Hampton Inn Georgetowne Marina
GTRCMHX	Hampton Inn and Suites Columbus,  MS
GUAGCGI	Hilton Garden Inn Guatemala City, Guatemala
GUEONHX	Hampton Inn and Suites Guelph, Ontario, Canada
GUMHITW	Hilton Guam Resort & Spa
GUPGIGI	Hilton Garden Inn Gallup, NM
GVANYHX	Hampton Inn Geneva, NY
GVEALHX	Hampton Inn Guntersville
GVITXHX	Hampton Inn and Suites Gainesville, TX
GVLFBHX	Hampton Inn and Suites Flowery Branch, GA
GVLGAHX	Hampton Inn Gainesville, GA
GVLGNGI	Hilton Garden Inn Gainesville
GVNCCHF	Hilton University of Florida
GWSCOHX	Hampton Inn Glenwood Springs
GXYCOHX	Hampton Inn and Suites Greeley, CO
GYEHIHF	Hilton Colon Guayaquil
GYYMRHX	Hampton Inn Merrillville
GYYSVHX	Hampton Inn and Suites Schererville
GZTCCHX	Hampton Inn Gaziantep City Centre
HADMAHX	Hampton Inn Hadley, MA
HAMLAHX	Hampton Inn Hammond
HAMRHQQ	Reichshof Hamburg, Curio Collection by Hilton
HANHITW	Hilton Hanoi Opera
HANOPGI	Hilton Garden Inn Hanoi
HANPAHX	Hampton Inn Hanover
HARCLHX	Hampton Inn Carlisle
HARGHHX	Hampton Inn Harrisburg/Grantville
HARHSHW	Homewood Suites Harrisburg East
HARHWHW	Homewood Suites by Hilton Harrisburg-West Hershey Area
HARNOHX	Hampton Inn and Suites Harrisburg/North, PA
HARPAHX	Hampton Inn Harrisburg East (Hershey)
HBGHAGI	Hilton Garden Inn Hattiesburg, MS
HBGMSHX	Hampton Inn Hattiesburg, MS
HBGWGHX	Hampton Inn and Suites Wiggins, MS
HCKSEGI	Hilton Garden Inn Hickory, NC
HCVKYHX	Hampton Inn Horse Cave
HDFGBHW	Homewood Suites by Hilton Hartford South-Glastonbury
HDSNCHX	Hampton Inn Henderson
HELAIHI	Hilton Helsinki Airport
HELHIHI	Hilton Helsinki Strand
HELKJHI	Hilton Helsinki Kalastajatorppa
HELMTHX	Hampton Inn Helena
HERPAHX	Hampton Inn and Suites Hershey
HFDFAHX	Hampton Inn and Suites Farmington, CT
HFDFMHW	Homewood Suites by Hilton Hartford-Farmington
HFDHHHF	Hilton Hartford
HFDMCHX	Hampton Inn and Suites Hartford-Manchester, CT
HFDMYHX	Hampton Inn and Suites Mystic, CT
HFDSTHW	Homewood Suites by Hilton Southington, CT
HGRHWHW	Homewood Suites by Hilton Hagerstown, MD
HGRMDHX	Hampton Inn Hagerstown
HGRMGHX	Hampton Inn Hagerstown I-81, MD
HHHBFGI	Hilton Garden Inn Beaufort, SC
HHHHEGI	Hilton Garden Inn Hilton Head
HIBHXHX	Hampton Inn Hibbing, MN
HIIAZHX	Hampton Inn Lake Havasu City, AZ
HILSCHX	Hampton Inn Hilton Head, SC
HKTHIHI	Hilton Phuket Arcadia Resort & Spa
HKTSBDI	DoubleTree Resort by Hilton Phuket - Surin Beach
HKYNCHX	Hampton Inn Hickory, NC (New)
HLBTXHX	Hampton Inn Hillsboro, TX
HLDMIHX	Hampton Inn Holland
HLGTXHX	Hampton Inn and Suites Harlingen
HLGWHHX	Hampton Inn and Suites Wheeling - The Highlands, WV
HLNGAHX	Hampton Inn Helen
HLVVAHX	Hampton Inn Hillsville
HMORSHX	Hampton Inn Hermosillo, Mexico
HMTCAHX	Hampton Inn and Suites Hemet, CA
HNLESES	Embassy Suites by Hilton Waikiki-Beachwalk
HNLHVHH	Hilton Hawaiian Village
HNLKADT	DoubleTree by Hilton Alana - Waikiki Beach
HNLKUGI	Hilton Garden Inn Waikiki Beach, HI
HNLWAHF	Hilton Waikiki Beach, HI
HNLWBGV	Hokulani Waikiki by Hilton Grand Vacations
HNVHHHX	Hampton Inn Hinesville
HOLHWHW	Homewood Suites by Hilton Holyoke-Springfield/North
HOPKIHX	Hampton Inn and Suites Hopkinsville, KY
HOTARHX	Hampton Inn Hot Springs
HOTESES	Embassy Suites by Hilton Hot Springs
HOUAMGI	Hilton Garden Inn Houston NW/America Plaza, TX
HOUAPDT	DoubleTree by Hilton Houston Intercontinental Airport
HOUBIHX	Hampton Inn and Suites Houston-Bush Intercontinental Airport
HOUBTHX	Hampton Inn Houston/Baytown
HOUBYHW	Homewood Suites By Hilton Houston Intercontinental Arpt
HOUCLHW	Homewood Suites by Hilton Houston/Clear Lake
HOUCVHH	Hilton Americas - Houston
HOUCYHX	Hampton Inn and Suites Houston/Cypress Station
HOUDBDT	DoubleTree by Hilton Houston-Downtown
HOUDNES	Embassy Suites by Hilton Houston Downtown
HOUDPHX	Hampton Inn Houston/Deer Park
HOUECHW	Homewood Suites by Hilton Houston West/Energy Corridor, TX
HOUENGI	Hilton Garden Inn Houston Energy Corridor
HOUESES	Embassy Suites by Hilton Houston-Near The Galleria
HOUEYES	Embassy Suites by Hilton Houston - Energy Corridor
HOUGHGI	Hilton Garden Inn Houston Galleria
HOUGLHW	Homewood Suites by Hilton Houston-Near the Galleria, TX
HOUGPHF	Hilton Houston North
HOUGWDT	DoubleTree by Hilton Houston - Greenway Plaza
HOUHBHX	Hampton Inn Houston Hobby Airport
HOUHKHT	Home2 Suites by Hilton Houston/Katy, TX
HOUHMHX	Hampton Inn Humble
HOUHNGI	Hilton Garden Inn Houston Northwest
HOUHODT	DoubleTree by Hilton Houston Hobby Airport
HOUHSHX	Hampton Inn and Suites Houston Clearlake Nasa
HOUHWHW	Homewood Suites by Hilton Houston Willowbrook Mall
HOUICGI	Hilton Garden Inn Houston/Bush Intercontinental Airport
HOUKFHX	Hampton Inn and Suites Houston I-10 Central, TX
HOUKWHW	Homewood Suites by Hilton Houston/Kingwood Parc/Airport Area
HOUKYHX	Hampton Inn and Suites Houston/Katy
HOULCHX	Hampton Inn and Suites Houston/League City, TX
HOUMCHF	Hilton Houston Plaza-Medical Center
HOUMDHX	Hampton Inn and Suites Houston Astrodome
HOUNBHF	Hilton Houston NASA Clear Lake
HOUNFHX	Hampton Inn Houston North
HOUNHHX	Hampton Inn and Suites Houston North IAH Geenspoint
HOUNOHX	Hampton Inn Houston/Brookhollow
HOUNTHW	Homewood Suites by Hilton Houston-Northwest/CY-FAIR
HOUNWHX	Hampton Houston Northwest
HOUPDHX	Hampton Inn and Suites Houston/Pasadena, TX
HOUPEGI	Hilton Garden Inn Houston Pearland
HOUPLHX	Hampton Inn Pearland
HOUPOHX	Hampton Inn Houston Near the Galleria
HOURGHX	Hampton Inn & Suites Houston/Rosenberg, TX
HOUSDHW	Homewood Suites by Hilton Houston-Stafford, TX
HOUSGGI	Hilton Garden Inn Houston Westbelt
HOUSLGI	Hilton Garden Inn Houston/Sugar Land, TX
HOUSOHX	Hampton Inn and Suites Houston-Westchase, TX
HOUSTHX	Hampton Inn Houston Stafford
HOUSWHF	Hilton Houston-Southwest
HOUSYDT	DoubleTree Suites by Hilton Houston by the Galleria
HOUTSQQ	The Sam Houston Hotel-Curio Collection By Hilton
HOUUHHF	Hilton University Of Houston
HOUWCHF	Hilton Houston-Westchase
HOUWDGI	Hilton Garden Inn Houston/Woodlands
HOUWEHX	Hampton Inn Houston I-10 West/Energy Corridor
HOUWKGI	Hilton Garden Inn Houston West/Katy, TX
HOUWLHW	Homewood Suites by Hilton The Woodlands, Texas
HOUWMHX	Hampton Inn Houston Willowbrook Mall
HOUWNGI	Hilton Garden Inn Houston/Clear Lake NASA
HOUWTHW	Homewood Suites by Hilton Houston/Westchase
HPNNAGI	Hilton Garden Inn Nanuet
HPNNUHX	Hampton Inn Nanuet, NY
HPTNCHX	Hampton Inn High Point
HRBPAHX	Hampton Inn Harrisburg West
HRGHITW	Hilton Hurghada Plaza
HRGHRHI	Hilton Hurghada Resort
HRGLBHI	Hilton Hurghada Long Beach Resort
HROBCHH	Hilton Branson Convention Center Hotel
HROBRHH	Hilton Promenade at Branson Landing
HRSARHX	Hampton Inn Harrison, AR
HSBSOHX	Hampton Inn Harrisonburg-South, VA
HSBUVHX	Hampton Inn Harrisonburg
HSTFLHX	Hampton Inn and Suites Homestead, FL
HSVALHX	Hampton Inn Huntsville-Arsenal/South Pkway, AL
HSVCLHX	Hampton Inn Cullman
HSVESES	Embassy Suites by Hilton Huntsville
HSVGSHW	Homewood Suites by Hilton Huntsville-Downtown
HSVHCHX	Hampton Inn and Suites Huntsville-Southeast/Hampton Cove, AL
HSVHRHX	Hampton Inn and Suites Huntsville/Research Park Area, AL
HSVHWHW	Homewood Suites by Hilton Huntsville/Village of Providence
HSVMPDT	DoubleTree Suites by Hilton Huntsville South
HSVMSHX	Hampton Inn Huntsville/Madison
HSVRPHT	Home2 Suites by Hilton Huntsville/Research Park Area, AL
HSVSBHX	Hampton Inn and Suites Scottsboro, AL
HSVSCGI	Hilton Garden Inn Huntsville/Space Center
HSVSOGI	Hilton Garden Inn Huntsville South/Redstone Arsenal, AL
HSVUVHX	Hampton Huntsville
HTSBVHX	Hampton Inn Huntington/Barboursville
HTSHUHX	Hampton Inn Huntington University Area, WV
HUBWHHF	The Waterfront Beach Hilton Resort
HUFHHHX	Hampton Terre Haute
HUFTHGI	Hilton Garden Inn Terre Haute, IN
HUMLAHX	Hampton Inn Houma
HUMMCHX	Hampton Inn and Suites Morgan City, LA
HUMTHHX	Hampton Inn and Suites Thibodaux, LA
HUTKSHX	Hampton Inn Hutcinson
HUYLNDI	DoubleTree by Hilton Lincoln
HVLNCHX	Hampton Inn Havelock
HVNOBHX	Hampton Inn Shelton, CT
HVNSHGI	Hilton Garden Inn Shelton
HYACCDT	DoubleTree by Hilton Cape Cod - Hyannis
HYNCCHX	Hampton Inn and Suites Cape Cod/West Yarmouth, MA
HYSKSHX	Hampton Inn Hays, KS
HZLHHHX	Hampton Inn Hazleton
IADAHHF	Hilton Washington-Dulles
IADCTHX	Hampton Inn and Suites Charles Town, WV
IADDNGI	Hilton Garden Inn Dulles North, VA
IADFHGI	Hilton Garden Inn Fairfax
IADFRGI	Hilton Garden Inn Frederick, MD
IADMRHF	Hilton Washington DC/Rockville Executive Meeting Center
IADSLDT	DoubleTree by Hilton Dulles Airport- Sterling
IAGDTDT	DoubleTree by Hilton Resort & Spa Fallsview/Niagara Falls
IAGESES	Embassy Suites by Hilton Niagara Fallsview
IAGRRHX	Hampton Inn Niagara Falls North of the Falls
IAHMCHX	Hampton Inn and Suites Missouri City, TX
IAHSPHW	Homewood Suites by Hilton The Woodlands/Springwoods Village
IAHTWES	Embassy Suites by Hilton The Woodlands at Hughes Landing
IAHWSHH	Hilton Houston-Post Oak
IASHXHX	Hampton By Hilton Iasi
ICTARDT	DoubleTree by Hilton Wichita Airport
ICTDBHX	Hampton Inn Derby, KS
ICTEAHX	Hampton Inn Wichita East
ICTHWHW	Homewood Suites by Hilton @ The Waterfront
ICTNOHX	Hampton Inn and Suites Wichita/North, KS
ICTSCHX	Hampton Inn and Suites Mulvane I-35, KS
ICTWHGI	Hilton Garden Inn Wichita
IDAAPHX	Hampton Inn Idaho Falls/Airport, ID
IDAIDHX	Hampton Inn Idaho Falls At The Mall, ID
IDAIFGI	Hilton Garden Inn Idaho Falls, ID
IDIPAHX	Hampton Inn and Suites Indiana, PA
IGMAZHX	Hampton Inn and Suites Kingman, AZ
IJXILHX	Hampton Inn Jacksonville, IL
IKKILHX	Hampton Inn Bradley/Kankakee
ILGCHHF	Hilton Wilmington-Christiana
ILGCPDT	DoubleTree by Hilton Wilmington
ILGDTDT	DoubleTree by Hilton Wilmington Downtown
ILGHWHW	Homewood Suites by Hilton Wilmington/Brandywine Valley
ILMEWHX	Hampton Inn Wilmington-Eastwood, NC
ILMMDHX	Hampton Inn Wilmington Medical Park
ILMMTHW	Homewood Suites by Hilton Wilmington/Mayfaire
ILMNCHF	Hilton Wilmington Riverside
ILMTCGI	Hilton Garden Inn Wilmington Mayfaire Town Center
ILMWVHX	Hampton Inn and Suites Wilmington/Wrightsville Beach
INDAGGI	Hilton Garden Inn Indianapolis Airport, IN
INDARHX	Hampton Inn and Suites Indianapolis-Airport, IN
INDCAGI	Hilton Garden Inn Indianapolis/Carmel
INDCICI	Conrad Indianapolis
INDCMHX	Hampton Inn Indianapolis/Carmel
INDCWHX	Hampton Inn & Suites Crawfordsville, IN
INDDHGI	Hilton Garden Inn Indianapolis Downtown
INDDNHF	Hilton Indianapolis
INDDTHX	Hampton Inn Indianapolis Downtown
INDFHGI	Hilton Garden Inn Indianapolis Northeast/Fishers
INDFSHX	Hampton Inn and Suites Indianapolis/Fishers
INDGWGI	Hilton Garden Inn Indianapolis South/Greenwood, IN
INDHWHW	Homewood Suites by Hilton Indianapolis-Downtown, IN
INDKCHW	Homewood Suites by Hilton Indianapolis @ the Crossing
INDNEHX	Hampton Inn Indianapolis/Castleton
INDNHES	Embassy Suites by Hilton Indianapolis-North
INDNOGI	Hilton Garden Inn Indianapolis/Northwest, IN
INDNWHW	Homewood Suites by Hilton Indianapolis Northwest, IN
INDOMDT	DoubleTree Suites by Hilton Indianapolis-Carmel
INDPDHW	Homewood Suites by Hilton Indianapolis Airport/Plainfield
INDPFHX	Hampton Inn Indianapolis/Plainfield
INDSBHX	Hampton Inn Shelbyville
INDSHHX	Hampton Inn Indianapolis East
INDSTHX	Hampton Inn Indianapolis South
INDWBHX	Hampton Inn and Suites Brownsburg, IN
INDWDHX	Hampton Inn Indianapolis Northwest
INDWWES	Embassy Suites by Hilton Indianapolis-Downtown
INDZVHX	Hampton Inn Indianapolis/Zionsville, IN
INNHIHI	Hilton Innsbruck
INTBRHX	Hampton Inn Bermuda Run/Advance I-40, NC
INTDBHX	Hampton Inn and Suites Dobson, NC
INTESES	Embassy Suites by Hilton Winston Salem
INTSTHX	Hampton Inn Winston-Salem Hanes Mall
INTUVHX	Hampton Inn and Suites Winston-Salem/University Area, NC
INTWSGI	Hilton Garden Inn Winston-Salem/Hanes Mall, NC
INTWUDT	DoubleTree by Hilton Winston Salem University
INVCOHN	Hilton Coylumbridge
IOWCVHW	Homewood Suites by Hilton Coralville - Iowa River Landing
IOWICHX	Hampton Inn Iowa City/University Area, IA
IPTTSHX	Hampton Inn and Suites Williamsport-Faxon Exit, PA
IRSMIHX	Hampton Inn Sturgis/Lagrange
ISNNRHX	Hampton Inn and Suites Williston, ND
ISONCHX	Hampton Inn Kinston
ISPAHGI	Hilton Garden Inn Islip / MacArthur Airport
ISPBHHX	Hampton Inn Long Island/Brookhaven
ISPHHHF	Hilton Long Island-Huntington
ISPICGI	Hilton Garden Inn New York Long Island City/Manhattan View,
ISPMVHT	Home2 Suites Long Island City
ISPNYHX	Hampton Inn Long Island/Islandia
ISPRHGI	Hilton Garden Inn Riverhead, NY
ISPSBGI	Hilton Garden Inn Stony Brook, NY
ISTATHX	Hampton Inn Istanbul Atakoy, TR
ISTAVDI	DoubleTree by Hilton Istanbul - Avcilar
ISTBHHI	Hilton Istanbul Bomonti Hotel & Conference Center, Turkey
ISTGHGI	Hilton Garden Inn Istanbul Golden Horn
ISTHCCI	Conrad Istanbul Bosphorus
ISTHITW	Hilton Istanbul Bosphorus
ISTIAGI	Hilton Garden Inn Istanbul Ataturk Airport
ISTIKDI	DoubleTree by Hilton Istanbul - Piyalepasa
ISTIMDI	DoubleTree by Hilton Istanbul - Moda
ISTKBHX	Hampton Inn Istanbul, Kayasehir, Turkey
ISTKOHI	Hilton Istanbul Kozyatagi
ISTOTDI	DoubleTree by Hilton Hotel Istanbul - Old Town
ISTPHTW	Hilton ParkSA Istanbul
ISTTIDI	DoubleTree by Hilton Hotel Istanbul - Tuzla
ITHHWHW	Homewood Suites by Hilton Ithaca, NY
ITHNYHX	Hampton Inn Ithaca, NY
ITOHNDT	Doubletree by Hilton Hilo, HI
IZMGIGI	Hilton Garden Inn Izmir Bayrakli
IZMHITW	Hilton Izmir
IZMIADI	DoubleTree by Hilton Izmir - Alsancak
JACHWHW	Homewood Suites by Hilton Jackson, WY
JACJHHX	Hampton Inn Jackson Hole, WY
JAIGHHI	Hilton Jaipur
JANCTHX	Hampton Inn Jackson/Clinton, MS
JANEAHX	Hampton Inn Jackson East, MS
JANHSHX	Hampton Inn & Suites Jackson Downtown-Coliseum
JANHWHW	Homewood Suites by Hilton Jackson
JANJHHF	Hilton Jackson
JANKZHX	Hampton Inn Yazoo City, MS
JANMHGI	Hilton Garden Inn Jackson/Madison, MS
JANPLHX	Hampton Inn Jackson/Pearl International Airport
JANRDHX	Hampton Inn Jackson/Richland-Highway 49, MS
JANRGES	Embassy Suites by Hilton Jackson - North Ridgeland
JANRLHT	Home2 Suites by Hilton Jackson/Ridgeland, MS
JANSPGI	Hilton Garden Inn Jackson/Pearl
JANTWGI	Hilton Garden Inn Jackson Downtown
JAXAHGI	Hilton Garden Inn Jacksonville Airport
JAXARDT	DoubleTree by Hilton Jacksonville Airport
JAXBPHX	Hampton Inn and Suites Jacksonville-South/Bartram Park, FL
JAXBYHX	Hampton Inn Jacksonville I-295 East/Baymeadows, FL
JAXDNHW	Homewood Suites Jacksonville Southbank
JAXDPGI	Hilton Garden Inn Jacksonville Deerwood Park
JAXDTHX	Hampton Inn Jacksonville-Downtown-I-95, FL
JAXDWHX	Hampton Inn and Suites Jacksonville-Deerwood Park, FL
JAXEAHX	Hampton Inn and Suites Jacksonville-East/Beach Blvd., FL
JAXHSHX	Hampton Inn and Suites Jacksonville-Airport, FL
JAXHWHW	Homewood Suites by Hilton Jacksonville-South/St. Johns Ctr
JAXJAES	Embassy Suites by Hilton Jacksonville-Baymeadows
JAXJBHX	Hampton Inn Jacksonville Beach/Oceanfront, FL
JAXJRDT	DoubleTree by Hilton Jacksonville Riverfront
JAXJSHX	Hampton Inn Jacksonville South/I-95 at JTB, FL
JAXOBGI	Hilton Garden Inn Jacksonville/Orange Park, FL
JAXPBHX	Hampton Inn Jacksonville/Ponte Vedra Beach-Mayo Clinic
JAXPVGI	Hilton Garden Inn Ponte Vedra
JAXRSHX	Hampton Inn Jacksonville East
JAXSBGI	Hilton Garden Inn Jacksonville Downtown
JAXWEHX	Hampton Inn Jacksonville I-10
JBKCADT	DoubleTree by Hilton Berkeley Marina, CA
JBRARHX	Hampton Inn Jonesboro
JBRJBGI	Hilton Garden Inn Jonesboro
JEDHIHI	Jeddah Hilton
JEDWAWA	Waldorf Astoria Jeddah - Qasr Al Sharq
JEFCCHX	Hampton Inn Jefferson City @ Capital Mall
JEFDTDT	DoubleTree by Hilton Jefferson City
JFKCPHW	Homewood Suites Carle Place/Garden City
JFKETDT	DoubleTree by Hilton Tinton Falls-Eatontown
JFKMLGI	Hilton Garden Inn Melville, NY
JFKQAGI	Hilton Garden Inn Queens/JFK Airport
JFKWEGI	Hilton Garden Inn Westbury
JHBDTDI	DoubleTree by Hilton Johor Bahru
JHCGCHX	Hampton Inn Garden City, NY
JHMGWWA	Grand Wailea Resort Hotel & Spa
JHWNKHX	Hampton Inn and Suites Jamestown, NY
JKTDIDI	DoubleTree by Hilton Jakarta - Diponegoro
JKVNCHT	Home2 Suites by Hilton Jacksonville, NC
JLNJMHW	Homewood Suites by Hilton Joplin, MO
JLNMOHX	Hampton Inn Joplin
JMSSWHX	Hampton Inn Jamestown, ND
JNBSATW	Hilton Sandton
JNSWIHX	Hampton Inn Janesville
JNVNCHX	Hampton Inn Jonesville/Elkin
JOLILHX	Hampton Inn Joliet @ I-55
JOLRBHX	Hampton Inn Joliet @ I-80
JOSEDT	DoubleTree by Hilton San Jose
JRSWAWA	Waldorf Astoria Jerusalem
JSBGIGI	Hilton Garden Inn San Bernardino, CA
JSBMVHX	Hampton Inn and Suites Moreno Valley, CA
JSTPAHX	Hampton Inn Johnstown
JVLCRHX	Hampton Inn Beloit
JVLEKHX	Hampton Inn Elkhorn, WI
JXNMIHX	Hampton Inn Jackson, MI
KALHWHW	Homewood Suites by Hilton Kalispell, MT
KAMBCHX	Hampton Inn Kamloops
KAMLODT	DoubleTree by Hilton Kamloops
KANKSHX	Hampton Inn Kansas City/Overland Park
KBPHIHI	Hilton Kyiv (Kiev) Ukraine
KCOHXHX	Hampton Inn Kocaeli, Turkey
KGPTNHX	Hampton Inn Kingsport
KILHHHX	Hampton Inn Killeen
KJAMSGI	Hilton Garden Inn Krasnoyarsk
KLFSSGI	Hilton Garden Inn Kaluga
KNGLDHX	Hampton Inn Kingsland, GA
KNXAHHF	Hilton Knoxville Airport, TN
KNXKHHF	Hilton Knoxville
KOAHWHH	Hilton Waikoloa Village
KOAKLGV	Kings' Land by Hilton Grand Vacations
KOKMOHX	Hampton Inn and Suites Kokomo
KOLCAES	Embassy Suites by Hilton Irvine-Orange County Airport
KRKAPGI	Hilton Garden Inn Krakow Airport
KRKCCDI	DoubleTree by Hilton Krakow Hotel & Convention Center
KRKGIGI	Hilton Garden Inn Krakow
KRKHXHX	Hampton by Hilton Krakow
KRRGIGI	Hilton Garden Inn Krasnodar
KSCDTDI	DoubleTree by Hilton Kosice
KUCHITW	Hilton Kuching
KUFSAHX	Hampton Inn Samara, Russia
KULDTDI	DoubleTree by Hilton Kuala Lumpur
KULHIHI	Hilton Kuala Lumpur
KUTKYHX	Hampton Inn Kuttawa/Eddyville
KVLTXHX	Hampton Inn Kerrville, TX
KVXGIGI	Hilton Garden Inn Kirov
KWIHIHI	Hilton Kuwait Resort
KYAGIGI	Hilton Garden Inn Konya
KYLGOHX	Hampton Inn Key Largo, FL
KYLGRHF	Key Largo Grande Hotel, a Hilton Resort
KZNCCDI	DoubleTree by Hilton Kazan City Center
LAFHHHX	Hampton Inn Lafayette, IN
LAFINHW	Homewood Suites by Hilton Lafayette
LAFWLGI	Hilton Garden Inn West Lafayette Wabash Landing
LAGGAHX	Hampton Inn LaGrange near Callaway Gardens, GA
LALLWHX	Hampton Inn and Suites Lake Wales, FL
LALPPHX	Hampton Inn and Suites Lakeland-South/Polk Parkway, FL
LAMNMHX	Hampton Inn and Suites Los Alamos
LANETHX	Hampton Inn East Lansing
LANLWHX	Hampton Inn and Suites Lansing/West, MI
LANOKHX	Hampton Inn and Suites Lansing/Okemos
LAPLAHX	Hampton Inn La Place
LAQCAES	Embassy Suites by Hilton La Quinta Hotel & Spa
LAQHWHW	Homewood La Quinta, CA
LARLAGI	Hilton Garden Inn Laramie
LARWYHX	Hampton Inn Laramie, WY
LASAPHW	Homewood Suites By Hilton - Las Vegas Airport
LASCCES	Embassy Suites by Hilton Las Vegas Conv Ctr-Paradise Road
LASCHDT	DoubleTree Club by Hilton Las Vegas Airport
LASCSGV	Elara, Hilton Grand Vacations-Center Strip
LASESES	Embassy Suites by Hilton Las Vegas
LASETHX	Hampton Inn and Suites Las Vegas Airport
LASGIGI	Hilton Garden Inn Las Vegas Strip South, NV
LASHEGI	Hilton Garden Inn Las Vegas/Henderson
LASHNHX	Hampton Inn and Suites Henderson
LASHWHW	Homewood Suites by Hilton Henderson/South Las Vegas, NV
LASINHX	Hampton Inn Las Vegas/Tropicana
LASLKHF	Hilton Lake Las Vegas Resort & Spa
LASNOHX	Hampton Inn Las Vegas/North Speedway
LASNTDT	Tropicana Las Vegas – a DoubleTree by Hilton Hotel & Resort
LASSMHX	Hampton Inn Las Vegas/Summerlin
LASSRHX	Hampton Inn and Suites Henderson/Saint Rose, NV
LASWSHX	Hampton Inn and Suites Las Vegas/West Summerlin, NV
LATCAHX	Hampton Inn and Suites Lathrop, CA
LAWDCHX	Hampton Inn Duncan, OK
LAWFGGI	Hilton Garden Inn Lawton-Fort Sill, OK
LAWOKHX	Hampton Inn and Suites Lawton, OK
LAWTNHW	Homewood Suites by Hilton Lawton, OK
LAXABES	Embassy Suites by Hilton Los Angeles-Intl Airport North
LAXACHX	Hampton Inn Los Angeles/Arcadia
LAXAGGI	Hilton Garden Inn LAX/El Segundo
LAXAHHH	Hilton Los Angeles Airport
LAXANES	Embassy Suites by Hilton Anaheim-North
LAXBHHH	Beverly Hilton
LAXBKHX	Hampton Inn Los Angeles-Burbank Airport, CA
LAXBRES	Embassy Suites by Hilton Brea-North Orange County
LAXCCDT	DoubleTree by Hilton Los Angeles - Westside
LAXCHHF	Hilton Checkers Los Angeles
LAXCMDT	DoubleTree by Hilton Los Angeles - Commerce
LAXDRGI	Hilton Garden Inn Los Angeles Marina Del Rey
LAXDTDT	DoubleTree by Hilton Los Angeles Downtown
LAXDWES	Embassy Suites by Hilton Los Angeles - Downey
LAXEGDT	DoubleTree by Hilton LAX/El Segundo
LAXESES	Embassy Suites by Hilton Los Angeles-Intl Airport South
LAXFHHX	Hampton Inn Irvine/East Lake Forest, CA
LAXGDES	Embassy Suites by Hilton Anaheim-South
LAXGGHX	Hampton Inn and Suites LA/Disneyland Area/Anaheim, CA
LAXHBHX	Hampton Inn and Suites Hermosa Beach
LAXHDES	Embassy Suites by Hilton Arcadia-Pasadena Area
LAXHOGI	Hilton Garden Inn Los Angeles/Hollywood
LAXHSHX	Hampton Inn and Suites Temecula Valley Wine Country
LAXHTHX	Hampton Inn Los Angeles-Int'l Airport/Hawthorne, CA
LAXHWHW	Homewood Suites by Hilton Anaheim-Main Gate Area
LAXMADT	DoubleTree by Hilton Hotel MDR, Marina del Rey, CA
LAXMVDT	DoubleTree by Hilton Monrovia - Pasadena Area
LAXNWDT	DoubleTree by Hilton Los Angeles - Norwalk
LAXOCHX	Hampton Inn  Los Angeles/Orange County/Cypress
LAXRBGI	Hilton Garden Inn Los Angeles/Redondo Beach, CA
LAXRMDT	DoubleTree by Hilton Los Angeles-Rosemead
LAXSBHX	Hampton Inn & Suites-Highland,CA
LAXSCHX	Hampton Inn and Suites San Clemente
LAXSGHF	Hilton San Gabriel
LAXTHDT	DoubleTree by Hilton Torrance
LAXTMES	Embassy Suites by Hilton Temecula Valley Wine Country
LAXTOHX	Hampton Inn and Suites Thousand Oaks, CA
LAXVLHX	Hampton Inn Los Angeles/Santa Clarita/Six Flags Area
LAXVNHX	Hampton Inn and Suites Los Angeles/Van Nuys, CA
LBACCDI	DoubleTree by Hilton Leeds City Centre
LBAYOHN	Hilton York
LBBESES	Embassy Suites by Hilton Lubbock
LBBHSHX	Hampton Inn and Suites Lubbock-Southwest, TX
LBBHWHW	Homewood Suites Lubbock
LBBTXHX	Hampton Inn Lubbock
LBFNEHX	Hampton Inn North Platte
LBGWVHX	Hampton Inn Lewisburg, WV
LBLKSHX	Hampton Inn and Suites Liberal, KS
LBNKYHX	Hampton Inn Lebanon, KY
LBTNCHX	Hampton Inn Lumberton, NC
LCCGIGI	Hilton Garden Inn Lecce
LCHLCHX	Hampton Inn Lake Charles, LA
LCJDLDI	DoubleTree by Hilton Lodz, Poland
LDLPAHW	Homewood Suites by Hilton Lansdale
LDNNJHX	Hampton Inn Linden
LEBFRHX	Hampton Inn and Suites Lebanon,  TN
LEEFLHX	Hampton Inn Leesburg, FL
LEEHNHN	Hilton Leeds City
LEHPAHX	Hampton Inn Lehighton - Jim Thorpe, PA
LENTNHX	Hampton Inn Lenoir City, TN
LEWAGHX	Hampton Inn Augusta
LEWAHGI	Hilton Garden Inn Auburn Riverwatch
LEXAPHX	Hampton Inn Lexington South
LEXDTHF	Hilton Lexington Downtown
LEXEHHX	Hampton Inn Lexington I-75
LEXESES	Embassy Suites by Hilton Lexington
LEXGEGI	Hilton Garden Inn Lexington/Georgetown, KY
LEXGTHX	Hampton Inn Lexington/Georgetown
LEXHBHW	Homewood Suites by Hilton Lexington/Hamburg, KY
LEXHSHS	Hilton Suites Lexington Green
LEXKYHW	Homewood Suites by Hilton Lexington
LEXLHGI	Hilton Garden Inn Lexington, KY
LEXMHHX	Hampton Inn and Suites Morehead, KY
LEXQQQQ	The Campbell House Lexington, Curio Collection by Hilton
LEXRRDT	DoubleTree Suites by Hilton Lexington
LEXWIHX	Hampton Inn Winchester
LFDILHX	Hampton Inn Litchfield, IL
LFTBRHX	Hampton Inn Broussard, LA
LFTCDGI	Hilton Garden Inn LaFayette/Cajundome, LA
LFTHSHX	Hampton Inn and Suites Lafayette
LFTJEHX	Hampton Inn and Suites Jennings, LA
LFTKSHW	Homewood Suites Lafayette
LFTLAHX	Hampton Inn Lafayette, LA
LFTLDDT	DoubleTree by Hilton Lafayette
LGARPGI	Hilton Garden Inn Ridgefield Park, NJ
LGASFDT	DoubleTree Suites by Hilton New York City - Times Squares
LGBCHDT	DoubleTree by Hilton Carson, CA
LGBLHHF	Hilton Long Beach
LGBMBGI	Hilton Garden Inn Los Angeles Montebello, CA
LGBMYDT	Hotel Maya - A DoubleTree by Hilton
LGBSBHX	Hampton Inn and Suites Seal Beach, CA
LGBSPDT	DoubleTree by Hilton San Pedro
LGUUTHX	Hampton Inn Logan
LHQOHHX	Hampton Inn Lancaster, OH
LHRAPTW	Hilton London Heathrow Airport
LHRATHI	Hilton London Heathrow Airport Terminal 5
LHRCLDI	DoubleTree by Hilton Heathrow Airport
LHREPGI	Hilton Garden Inn London Heathrow Airport
LHRHITW	Hilton London Kensington
LHRHRHI	Hilton Reading
LHRLBDI	DoubleTree by Hilton London - West End
LHROLHN	Hilton London Olympia
LHRSPHI	Hilton London Syon Park
LIHWBGI	Hilton Garden Inn Kauai/Wailua Bay, HI
LIMOHHX	Hampton Inn Lima
LIMPUDT	DoubleTree by Hilton El Pardo Lima, Peru
LINHSHX	Hampton Inn and Suites Chicago/Lincolnshire
LIONHF	Hilton Bellevue
LISFPDI	DoubleTree by Hilton Lisbon - Fontana Park
LITBLHX	Hampton Inn and Suites Lonoke, AR
LITBYHX	Hampton Inn Bryant, AR
LITCPES	Embassy Suites by Hilton Little Rock
LITCWGI	Hilton Garden Inn Conway
LITDTHX	Hampton Inn and Suites Little Rock/Downtown, AR
LITMBDT	DoubleTree by Hilton Little Rock
LITMMHX	Hampton Inn Maumelle, AR
LITNLGI	Hilton Garden Inn North Little Rock, AR
LITWSGI	Hilton Garden Inn Little Rock West, AR
LITWTHX	Hampton Inn and Suites Little Rock West
LIVTXHX	Hampton Inn Livingston, TX
LJNBCHX	Hampton Inn and Suites Bay City, TX
LJNCLHX	Hampton Inn and Suites Lake Jackson-Clute, TX
LKCFLHX	Hampton Inn and Suites Lake City, FL
LKGNYHX	Hampton Inn and Suites Lake George, NY
LKMFLHW	Homewood Suites by Hilton Lake Mary
LKMHSHX	Hampton Inn and Suites Lake Mary @ Colonial Townpark
LKPMLHX	Hampton Inn and Suites Lake Placid, NY
LLKFLHX	Hampton Inn and Suites Lady Lake/The Villages, FL
LNKDHGI	Hilton Garden Inn Lincoln Downtown/Haymarket
LNKESES	Embassy Suites by Hilton Lincoln
LNKNEHX	Hampton Inn Lincoln South/Heritage Park
LNKNHHX	Hampton Inn and Suites Lincoln Northeast/I-80, NE
LNSGFHX	Hampton Inn Lancaster
LNSHWHW	Homewood Suites by Hilton Lancaster, PA
LNSLHGI	Hilton Garden Inn Lancaster
LNSWVDT	DoubleTree by Hilton Resort Lancaster/Willow Valley
LNVPAHX	Hampton Inn Downington/Exton
LOMCAES	Embassy Suites by Hilton Lompoc-Central Coast
LONCOCI	Conrad London St. James
LONCWHI	Hilton London Canary Wharf
LONECDI	DoubleTree by Hilton London - Ealing
LONEUHI	Hilton London Euston
LONEXDI	Doubletree by Hilton London ExCel, United Kingdom
LONGNHX	Hampton By Hilton Gatwick North
LONGPTW	Hilton London Green Park
LONHITW	London Hilton on Park Lane
LONHPHN	Hilton London Hyde Park
LONHYDI	DoubleTree by Hilton London-Hyde Park
LONISHN	Hilton London Angel Islington
LONLCDI	DoubleTree by Hilton London - Chelsea
LONLIDI	DoubleTree by Hilton London-Islington, United Kingdom
LONLKDI	Doubletree by Hilton London Kensington, United Kingdom
LONLWHI	Hilton London Wembley
LONMADI	DoubleTree by Hilton London - Marble Arch
LONMETW	Hilton London Metropole
LONNDDI	DoubleTree by Hilton London - Docklands Riverside
LONPDHI	Hilton London Paddington
LONSBHI	Hilton London Bankside
LONTBHI	Hilton London Tower Bridge
LONTLDI	DoubleTree by Hilton London - Tower of London
LONTSHI	The Trafalgar, London
LONVCDI	DoubleTree by Hilton London - Victoria
LONWAHI	The Waldorf Hilton, London
LONWLHX	Hampton By Hilton London Waterloo
LONWMDI	DoubleTree by Hilton London -Westminster
LOZWBHX	Hampton Inn Williamsburg, KY
LPKMDHX	Hampton Inn Lexington Park
LPLDLDI	DoubleTree by Hilton Hotel & Spa Liverpool
LPLHIHI	Hilton Liverpool City Centre
LPLJLHX	Hampton Inn Liverpool John Lennon Airport
LPLLCHX	Hampton by Hilton Liverpool City Centre
LPTINHX	Hampton Inn Laporte
LRDESES	Embassy Suites by Hilton Laredo
LRDHWHW	Homewood Suites by Hilton Laredo at Mall del Norte
LRDTXHX	Hampton Inn Laredo
LRLJFHX	Hampton Inn and Suites Laurel, MS
LRNBGHX	Hampton Inn Laurinburg
LRUDMHX	Hampton Inn Deming, NM
LRUHSHX	Hampton Inn and Suites Las Cruces, NM
LRULBHX	Hampton Inn Lordsburg, NM
LRULCGI	Hilton Garden Inn Las Cruces, NM
LSETOHX	Hampton Inn Tomah, WI
LSEWIHX	Hampton Inn La Crosse/Onalaska
LTNDTDI	DoubleTree by Hilton Milton Keynes
LTNLAHX	Hampton Luton Airport
LTNNHHX	Hampton Inn Littleton, NH
LTNNOGI	Hilton Garden Inn Luton North
LUFTXHX	Hampton Inn and Suites Lufkin
LUXHITW	Hilton Luxor Resort & Spa
LVKCAHX	Hampton Livermore East Bay
LVKLHGI	Hilton Garden Inn Livermore
LWCMDDT	Doubletree by Hilton Lawrence, KS
LWGPAHX	Hampton Inn Lewisburg, PA
LWRKSHX	Hampton Inn Lawrence
LXMHIDI	DoubleTree by Hilton Luxembourg
LYHLVGI	Hilton Garden Inn Lynchburg, VA
LYHWLHX	Hampton Inn and Suites Lynchburg, VA
MAAHIHI	Hilton Chennai
MADAPHI	Hilton Madrid Airport
MAFBSHX	Hampton Inn and Suites Big Spring, TX
MAFDBGI	Hilton Garden Inn Midland, TX
MAFDCHT	Home2 Suites by Hilton Midland, TX
MAFDTDT	DoubleTree by Hilton Midland Plaza
MAFGIGI	Hilton Garden Inn Odessa, TX
MAFHAHX	Hampton Inn Midland, TX
MAFODHW	Homewood Suites by Hilton Odessa, TX
MAFTWHW	Homewood Suites by Hilton Midland, TX
MAHNJHW	Homewood Suites Mahwah
MAHWHHX	Hampton Inn and Suites Mahwah, NJ
MAKHITW	Makkah Hilton Hotel
MAKSUHI	Hilton Suites Makkah
MAKTWHI	Makkah Hilton Towers
MANDGHI	Hilton Manchester Deansgate
MANDTDI	DoubleTree by Hilton Hotel & Spa Chester
MANGIGI	Hilton Garden Inn Manhattan, KS
MANHITW	Hilton Manchester Airport
MANKSHX	Hampton Inn Manhattan
MANPDDI	DoubleTree by Hilton Hotel Manchester - Piccadilly
MARILHX	Hampton Inn Marion, IL
MAXVAHX	Hampton Inn Ft. Chiswell/Max Meadows
MBGINHX	Hampton Inn Martinsburg South-Inwood, WV
MBGWVHX	Hampton Inn Martinsburg
MBJDRQQ	Jewel Dunn's River Resort & Spa, Curio Collection by Hilton
MBJPCQQ	Jewel Paradise Cv Resort & Spa - Curio Collection By Hilton
MBJRHHF	Hilton Rose Hall Resort & Spa, JM
MBSBCDT	DoubleTree by Hilton Bay City-Riverfront
MBSBRHX	Hampton Inn Birch Run/Frankenmuth
MBSSGHX	Hampton Inn & Suites Saginaw,MI
MBTDTDT	DoubleTree by Hilton Murfreesboro
MBTESES	Embassy Suites by Hilton Murfreesboro
MBTOFHX	Hampton Inn and Suites Murfreesboro, TN
MCAOKHX	Hampton Inn and Suites McAlester, OK
MCCOMHX	Hampton Inn and Suites McComb, MS
MCECAHX	Hampton Inn and Suites Merced, CA
MCHILHX	Hampton Inn McHenry
MCIAPHF	Hilton Kansas City-Airport
MCIINGI	Hilton Garden Inn Independence
MCIKCGI	Hilton Garden Inn Kansas City/Kansas
MCIMSDT	DoubleTree by Hilton Overland Park, KS
MCIOLGI	Hilton Garden Inn Olathe, KS
MCIOPGI	Hilton Garden Inn Overland Park
MCIPRHF	Hilton President Kansas City
MCLMHHH	Hilton McLean Tysons Corner
MCNGAGI	Hilton Garden Inn Macon/Mercer University, GA
MCNHWHW	Homewood Suites by Hilton Macon-North, GA
MCNMLHX	Hampton Inn Milledgeville, GA
MCNNOHX	Hampton Inn and Suites Macon I-75 North, GA
MCNWRGI	Hilton Garden Inn Warner Robins, GA
MCOAFHW	Homewood Suites by Hilton Orlando-UCF Area
MCOAKHX	Hampton Inn and Suites Orlando/Apopka, FL
MCOALHX	Hampton Inn and Suites Orlando-North/Altamonte Springs, FL
MCOAPHX	Hampton Inn Orlando Airport
MCOATES	Embassy Suites by Hilton Orlando Airport
MCOBVGI	Hilton Garden Inn Lake Buena Vista/Orlando, FL
MCOCCHX	Hampton Inn Orlando Convention Center
MCOCMHX	Hampton Inn and Suites Clermont, FL
MCOCVHW	Homewood Suites by Hilton Orlando-Intl Drive/Convention Ctr
MCODTES	Embassy Suites by Hilton Orlando-Downtown
MCOFHDT	DoubleTree Suites by Hilton Walt Disney World
MCOFMHX	Hampton Inn Orlando Florida Mall
MCOGTHW	Homewood Suites by Hilton Orlando Airport, FL
MCOGWHX	Hampton Inn and Suites Orlando Airport @ Gateway Village, FL
MCOHNDT	DoubleTree by Hilton Orlando Airport
MCOHWHW	Homewood Suites by Hilton Orlando-Nearest to Univ Studios
MCOIDHX	Hampton Inn and Suites Orlando International Drive North
MCOITES	Embassy Suites by Hilton Orlando-Intl Dr-Jamaican Court
MCOJYHX	Hampton Inn and Suites Orlando-John Young Parkway/South Park
MCOKKHX	Hampton Inn Orlando South of Universal Studios
MCOLAGI	Hilton Garden Inn Lakeland, FL
MCOLKES	Embassy Suites by Hilton Orlando-Lake Buena Vista South
MCOLLHX	Hampton Inn Lakeland
MCOLVHX	Hampton Inn Orlando/Lake Buena Vista
MCOMDGV	Parc Soleil by Hilton Grand Vacations Club
MCOMLHW	Homewood Suites by Hilton Orlando/Maitland
MCOODDT	DoubleTree by Hilton Orlando Downtown
MCOORES	Embassy Suites by Hilton Orlando/Intl Drive South-Convention
MCOOSHX	Hampton Inn and Suites Orlando/South Lake Buena Vista, FL
MCOSPES	Embassy Suites by Hilton Orlando-North
MCOSRDT	DoubleTree by Hilton Resort Orlando - International Drive
MCOSWHX	Hampton Inn Orlando South of Walt Disney
MCOUBGV	Las Palmeras, a Hilton Grand Vacations Club
MCOUCHX	Hampton Inn and Suites Orlando UCF
MCOUNDT	DoubleTree by Hilton Orlando Universal-At The Entrance
MCOVSHW	Homewood Suites by Hilton Lake Buena Vista - Orlando
MCOWDES	Embassy Suites by Hilton Orlando - Lake Buena Vista Resort
MCOWHHX	Hampton Inn Orlando @ Universal Studios
MDORAHX	Hampton Inn Mount Dora
MDTGHGI	Hilton Garden Inn Gettysburg
MDTHAGI	Hilton Garden Inn Harrisburg East
MDTHEGI	Hilton Garden Inn Hershey
MDTHHHF	Hilton Harrisburg
MDTHRHX	Hampton Inn & Suites Hershey Near the Park, PA
MDTYSHX	Hampton Inn and Suites York/South, PA
MDWAHGI	Hilton Garden Inn Chicago/Midway Airport
MDWINGI	Hilton Garden Inn Merrillville, IN
MDWKAGI	Hilton Garden Inn Kankakee, IL
MDWTPGI	Hilton Garden Inn Chicago/Tinley Park
MEAHWHW	Homewood Suites by Hilton East Rutherford/Meadowlands, NJ
MEANJES	Embassy Suites by Hilton Secaucus-Meadowland, NJ
MEBNCHX	Hampton Inn Mebane
MEDHIHI	Madinah Hilton Hotel
MEIMEGI	Hilton Garden Inn Meridian, MS
MEIMSHX	Hampton Inn Meridian
MEJPAHX	Hampton Inn Meadville, PA
MELFSDI	DoubleTree by Hilton Melbourne - Flinders Street
MELSWHI	Hilton Melbourne South Wharf
MEMCVHX	Hampton Inn Memphis/Collierville
MEMDNDT	DoubleTree by Hilton Memphis Downtown
MEMEHDT	DoubleTree by Hilton Memphis
MEMGTHW	Homewood Suites by Hilton Memphis/Germantown
MEMHSHX	Hampton Inn and Suites Memphis Galleria
MEMHWHW	Homewood Suites by Hilton Southwind - Hacks Cross
MEMMAHX	Hampton Inn Marion, AR
MEMMLHX	Hampton Inn and Suites Millington, TN
MEMMRHX	Hampton Inn Hernando, MS
MEMMSHT	Home2 Suites by Hilton Memphis-Southaven, MS
MEMPBHX	Hampton Inn and Suites Memphis Peabody Place
MEMPEES	Embassy Suites by Hilton Memphis
MEMPHHF	Hilton Memphis
MEMPOHW	Homewood Suites by Hilton Memphis-East
MEMPRHX	Hampton Inn Memphis Poplar
MEMSGHX	Hampton Inn and Suites Memphis Shady Grove
MEMSHGI	Hilton Garden Inn Memphis/Southhaven
MEMSOHX	Hampton Inn Memphis/Southaven
MEMSWHX	Hampton Inn Memphis Southwind
MEMWGHX	Hampton Inn Memphis Walnut Grove
MERCTHX	Hampton Inn Meriden
MERHITW	Mersin HiltonSA Hotel
MESHPHF	Hilton Phoenix East-Mesa
METOHHX	Hampton Inn Marietta
MEXAHHF	Hilton Mexico City Airport
MEXCHHX	Hampton Inn and Suites Mexico City Centro Historico
MEXRFHH	Hilton Mexico City Reforma
MEXSAHH	Hilton Santa Fe Mexico City
MFDHSHX	Hampton Inn & Suites Mansfield-South @ I-71
MFDONHX	Hampton Inn Mansfield/Ontario
MFEDTDT	DoubleTree by Hilton McAllen
MFEMHGI	Hilton Garden Inn McAllen Airport
MFEMSHX	Hampton Inn Mission
MFEPRHX	Hampton Inn Pharr
MFESPHX	Hampton Inn and Suites McAllen, TX
MFEWRHW	Homewood Suites by Hilton McAllen, TX
MFRHWHW	Homewood Suites by Hilton Medford, OR
MFRORHX	Hampton inn Medford
MGAHFHF	Hilton Princess Managua
MGMACHX	Hampton Inn Alexander City, AL
MGMCFHX	Hampton Inn and Suites Prattville, AL
MGMDNHX	Hampton Inn and Suites Montgomery-Downtown, AL
MGMESES	Embassy Suites by Hilton Montgomery - Conference Center
MGMGIGI	Hilton Garden Inn Montgomery East
MGMHHHX	Hampton Inn Montgomery I-65 South/Hope Hull, AL
MGMHSHX	Hampton Inn and Suites Montgomery Eastchase
MGMHWHW	Homewood Suites by Hilton Montgomery
MGMMADT	DoubleTree by Hilton Montgomery Downtown
MGWGIGI	Hilton Garden Inn Morgantown
MGWVVHX	Hampton Inn Morgantown
MHKJCHX	Hampton Inn Junction City
MHMPAHX	Hampton Inn Manheim
MHOIDHX	Hampton Inn and Suites Mountian Home, ID
MHTBFHX	Hampton Inn and Suites Manchester/Bedford
MHTDTGI	Hilton Garden Inn Manchester Downtown
MHTEXHX	Hampton Inn and Suites Exeter, NH
MHTHWHW	Homewood Suites Manchester
MHTPDGI	Hilton Garden Inn Portsmouth
MIAAHHH	Hilton Miami Airport
MIAAIGI	Hilton Garden Inn Miami Airport West
MIABLHW	Homewood Suites Miami-Airport/Blue Lagoon
MIABMHF	Hilton Bentley Miami/South Beach
MIABSDT	DoubleTree by Hilton Grand Hotel Biscayne Bay
MIABVHX	Hampton Inn and Suites Miami/Brickell-Downtown, FL
MIACGHX	Hampton Inn Miami Coconut Grove/Coral Gables
MIACICI	Conrad Miami
MIADLHX	Hampton Inn Miami/Dadeland
MIADTHF	Hilton Miami Downtown
MIAFAHT	Home2 Suites by Hilton Florida City, FL
MIAFLHX	Hampton Inn & Suites Miami  Doral/Dolphin Mall
MIAHSHX	Hampton Inn and Suites Miami Airport South
MIAMADT	DoubleTree by Hilton Miami Airport Convention Center, FL
MIAMBHF	Hilton Cabana Miami Beach
MIAOPDT	DoubleTree by Hilton Ocean Point Resort & Spa - Miami Beach
MIASBGI	Hilton Garden Inn Miami South Beach-Royal Polo
MIASPES	Embassy Suites by Hilton Miami - International Airport
MIASTHX	Hampton Inn Miami/South Beach-17th Street, FL
MIAVHQQ	Vintro Hotel Miami Beach, Curio Collection by Hilton
MIAWEHX	Hampton Inn Miami Airport West
MIAWTHW	Homewood Suites by Hilton Miami - Airport West
MIEINHX	Hampton Inn and Suites Muncie, IN
MIFGIGI	Hilton Garden Inn Milford
MIFPLHX	Hampton Inn Milford
MIKHNHN	Hilton Milton Keynes
MILCAES	Embassy Suites by Hilton Milpitas-Silicon Valley
MILGIGI	Hilton Garden Inn Milan North
MILHITW	Hilton Milan
MITSDHX	Hampton Inn Mitchell
MIWIAHX	Hampton Inn and Suites Marshalltown, IA
MKCAPHW	Homewood Suites by Hilton Kansas City Airport
MKCATHX	Hampton Inn Kansas City Airport
MKCBEHX	Hampton Inn Belton/Kansas City Area, MO
MKCBSHX	Hampton Inn Kansas City/Blue Springs
MKCFDHX	Hampton Inn Kansas City Downtown Financial District, MO
MKCHSHX	Hampton Inn and Suites Kansas City County Club Plaza
MKCHWHW	Homewood Suites by Hilton Kansas City/Overland Park
MKCLBHX	Hampton Inn Kansas City/Liberty
MKCLSHX	Hampton Inn Kansas City Lees Summit
MKCMCES	Embassy Suites by Hilton Kansas City-Overland Park
MKCMRHX	Hampton Inn and Suites Mansas City/Merriam
MKCOLHX	Hampton Inn Olathe
MKCPDES	Embassy Suites by Hilton Kansas City-International Airport
MKCSMHX	Hampton Inn Kansas City/Shawnee Mission
MKCSWHX	Hampton Inn Kansas City Village West
MKCWEES	Embassy Suites by Hilton Kansas City- Plaza
MKCWOHX	Hampton Inn Kansas City/Near Worlds of Fun, MO
MKEAPHX	Hampton Inn Milwaukee Airport
MKEBFHX	Hampton Inn Milwaukee/Brookfield
MKEBKDT	DoubleTree by Hilton Milwaukee/Brookfield
MKEBLHX	Hampton Inn Burlington, WI
MKECCDT	DoubleTree by Hilton Milwaukee City Center
MKEDWHX	Hampton Inn and Suites Milwaukee Downtown, WI
MKEGFHX	Hampton Inn and Suites Grafton, WI
MKEGIGI	Hilton Garden Inn Milwaukee Airport, WI
MKELLHX	Hampton Inn Milwaukee Northwest
MKEMDGI	Hilton Garden Inn Milwaukee Downtown, WI
MKEMHHF	Hilton Milwaukee-City Center
MKEOCGI	Hilton Garden Inn Oconomowoc, WI
MKEPPGI	Hilton Garden Inn Milwaukee Park Place
MKGMIHX	Hampton Inn Muskegon
MKLDTDT	DoubleTree by Hilton Jackson
MKLHSHX	Hampton Inn and Suites Jackson, TN
MKLMIHX	Hampton Inn Milan, TN
MKTMDGI	Hilton Garden Inn Mankato Downtown, MN
MLAHITW	Hilton Malta
MLBASDT	DoubleTree by Hilton Cocoa Beach-Oceanfront
MLBBODT	DoubleTree Suites by Hilton Melbourne Beach Oceanfront
MLBDKHX	Hampton Inn Melbourne
MLBHIHF	Hilton Melbourne Oceanfront
MLBMHHF	Hilton Melbourne Rialto Place
MLBSLGI	Hilton Garden Inn at PGA Village/Port St. Lucie
MLBVIHX	Hampton Inn Melbourne/Viera, FL
MLDMIHX	Hampton Inn Midland, MI
MLEHICI	Conrad Maldives Resort & Spa Rangali Island
MLETNHX	Hampton Inn Middletown, DE
MLHHSHX	Hampton Inn and Suites Mill Hall/Lamar I-80, PA
MLIATHX	Hampton Inn and Suites Moline/Quad City International Arprt
MLIBQGI	Hilton Garden Inn Bettendorf/Quad Cities, IA
MLTNYHX	Hampton Inn Middletown
MLUWEHX	Hampton Inn West Monroe, LA
MLUWMGI	Hilton Garden Inn West Monroe, LA
MLVNYHW	Homewood Suites by Hilton Long Island-Melville
MLXMADI	DoubleTree by Hilton Malatya
MMIOKHX	Hampton Inn Miami, OK
MNLMBCI	Conrad Manila, Philippines
MNONCHX	Hampton Inn Charlotte/Monroe
MNZHAHX	Hampton Mannassas
MNZWBHW	Homewood Suites by Hilton Woodbridge, VA
MNZWSHX	Hampton Inn and Suites Woodstock, VA
MOBAPHX	Hampton Inn and Suites Mobile Airport Blvd.
MOBATHX	Hampton Inn Atmore, AL
MOBCUQQ	The Admiral Hotel Mobile-Curio Collection by Hilton
MOBDTHX	Hampton Inn and Suites Mobile-Downtown, AL
MOBEBHX	Hampton Inn Mobile East Bay/Daphne
MOBEHGI	Hilton Garden Inn Mobile East Bay/Daphne
MOBFHHX	Hampton Inn Fairhope-Mobile Bay, AL
MOBHMHW	Homewood Suites by Hilton Mobile-East Bay-Daphne, AL
MOBHWHW	Homewood Suites by Hilton Mobile I-65/Airport Boulevard, AL
MOBJCHX	Hampton Inn Jackson, AL
MOBMCHX	Hampton Inn and Suites Mobile-Medical Center/Airport, AL
MOBMKHX	Hampton Inn Foley, AL
MOBOBHX	Hampton Inn Orange Beach/Gulf Front
MOBPPHW	Homewood Suites Mobile Airport-University Area
MOBTCHX	Hampton Inn Mobile/Bellingrath Gardens
MOBWSGI	Hilton Garden Inn Mobile West I-65/Airport Blvd.
MODHSHX	Hampton Inn and Suites Modesto Salida
MORNCHX	Hampton Inn Morehead City,NC
MOTNDHX	Hampton Inn and Suites Minot/Airport, ND
MOWMLDI	DoubleTree by Hilton Moscow-Marina, Russia
MOWMSHX	Hampton Inn Moscow Strogino
MOWNRGI	Hilton Garden Inn Moscow New Riga, Russia
MPECUQQ	Madison Beach Hotel-Curio Collection By Hilton
MPTMIHX	Hampton Inn Mount Pleasant
MQBILHX	Hampton Inn Macomb, IL
MQMGIGI	Hilton Garden Inn Mardin
MQTWFHX	Hampton Inn Marquette/Waterfront, MI
MQYSMGI	Hilton Garden Inn Nashville/Smyrna, TN
MQYTNHX	Hampton Inn and Suites Nashville/Smyrna, TN
MRKMHHF	Hilton Marco Island
MRLMIHX	Hampton Inn Marshall, MI
MRNINHX	Hampton Inn Marion, IN
MRTTNHX	Hampton Inn Martin, TN
MRUHIHI	Hilton Mauritius Resort & Spa
MRVNCHX	Hampton Inn Mooresville/Lake Norman, NC
MRYESES	Embassy Suites by Hilton Monterey Bay-Seaside
MRYMHGI	Hilton Garden Inn Monterey
MSGOKHX	Hampton Inn Muskogee
MSHTXHX	Hampton Inn Marshall, TX
MSLOHHX	Hampton Inn Massillon
MSNBJHX	Hampton Inn and Suites Madison/Downtown, WI
MSNDTDT	DoubleTree by Hilton Madison
MSNEAHX	Hampton Inn Madison East Towne Mall
MSNHWHW	Homewood Suites by Hilton Madison West, WI
MSNMHHF	Hilton Madison Monona Terrace
MSNWDGI	Hilton Garden Inn Wisconsin Dells
MSNWHGI	Hilton Garden Inn Madison West/Middleton
MSNWTHX	Hampton Inn and Suites Madison West, WI
MSOGIGI	Hilton Garden Inn Missoula, MT
MSOMTHX	Hampton Inn Missoula
MSPAHHF	Hilton Minneapolis-Airport
MSPAMHX	Hampton Inn and Suites Minneapolis-St. Paul Airport, MN
MSPAPES	Embassy Suites by Hilton Minneapolis-Airport
MSPBLGI	Hilton Garden Inn Bloomington
MSPBRES	Embassy Suites by Hilton Minneapolis-North, MN
MSPBSDT	DoubleTree by Hilton Bloomington-Minneapolis South
MSPBVHX	Hampton Inn Minneapolis/Burnsville
MSPBWHF	Hilton Minneapolis South Bloomington Hotel
MSPCNGI	Hilton Garden Inn Minneapolis Downtown, MN
MSPEGHX	Hampton Inn Minneapolis/Eagan
MSPEHGI	Hilton Garden Inn Minneapolis/Eagan
MSPEPGI	Hilton Garden Inn Minneapolis/Eden Prairie
MSPHWHW	Homewood Suites by Hilton Minneapolis - Mall of America
MSPLLHX	Hampton Inn and Suites Lino Lakes, MN
MSPLPHW	Homewood Suites by Hilton Minneapolis/St. Louis Park
MSPLSDT	DoubleTree Suites by Hilton Minneapolis
MSPMAGI	Hilton Garden Inn Minneapolis/Maple Grove
MSPMGHX	Hampton Inn Minneapolis/Maple Grove
MSPMHHH	Hilton Minneapolis
MSPMSDT	DoubleTree by Hilton St Paul Downtown
MSPNBHW	Homewood Suites by Hilton Minneapolis/New Brighton, MN
MSPNODT	DoubleTree by Hilton Minneapolis North
MSPOHGI	Hilton Garden Inn St. Paul/Oakdale
MSPPHDT	DoubleTree by Hilton Minneapolis-Park Place
MSPSHGI	Hilton Garden Inn St. Paul-Shoreview
MSPSKHX	Hampton Inn Minneapolis/Shakopee, MN
MSPSPES	Embassy Suites by Hilton St Paul-Downtown
MSPSVHX	Hampton Inn Minneapolis/St. Paul North
MSPVIHH	The Marquette Hotel
MSPWBHX	Hampton Inn and Suites Minneapolis/West-Minnetonka, MN
MSPWDHX	Hampton Inn Minneapolis/St. Paul/Woodbury
MSPWEES	Embassy Suites by Hilton Bloomington
MSQHXHX	Hampton By Hilton Minsk
MSYAHHH	Hilton New Orleans Airport
MSYCCES	Embassy Suites by Hilton New Orleans
MSYDTHX	Hampton Inn New Orleans Downtown
MSYELHX	Hampton Inn and Suites New Orleans/Elmwood
MSYFQHF	Hilton New Orleans St. Charles Ave.
MSYGDHX	Hampton Inn New Orleans St. Charles Ave.
MSYGIGI	Hilton Garden Inn New Orleans Convention Center
MSYHAHX	Hampton Inn and Suites Harvey, LA
MSYHWHW	Homewood Suites New Orleans Downtown
MSYKNDT	DoubleTree by Hilton New Orleans Airport
MSYKPGI	Hilton Garden Inn New Orleans Airport
MSYLAHX	Hampton Inn and Suites New Orleans Convention Center
MSYMTHX	Hampton Inn New Orleans/Metairie
MSYNHHH	Hilton New Orleans Riverside
MSYNSHW	Homewood Suites by Hilton Slidell, LA
MSYORGI	Hilton Garden Inn New Orleans French Quarter/CBD
MSYRHWA	The Roosevelt New Orleans Waldorf Astoria
MSYSDHX	Hampton Inn Slidell
MSYTCDT	DoubleTree by Hilton New Orleans
MTANCHX	Hampton Inn Mount Airy
MTHNJHX	Hampton Inn Burlington/Mount Holly
MTJCOHX	Hampton Inn Montrose, CO
MTNRIHX	Hampton Inn and Suites Newport Middletown
MTOILHX	Hampton Inn Mattoon
MTPTXHX	Hampton Inn and Suites Mt. Pleasant, TX
MTVVAHX	Hampton Inn Martinsville
MTWTNHX	Hampton Inn Morristown
MTYAPHX	Hampton Inn Monterrey Airport
MTYGAHX	Hampton Inn Monterrey Gallerias
MTYMHGI	Hilton Garden Inn Monterrey
MUCCHTW	Hilton Munich City
MUCHITW	Hilton Munich Park
MUCTMHI	Hilton Munich Airport
MURNCHX	Hampton Inn Murphy, NC
MUTIAHX	Hampton Inn Muscatine, IA
MVDMVGI	Hilton Garden Inn Montevideo, Uruguay
MVLKYHX	Hampton Inn and Suites Madisonville, KY
MVNHHHX	Hampton Inn Mount Vernon
MVWBLHX	Hampton Inn and Suites Burlington, WA
MWHNJDT	DoubleTree by Hilton Mahwah
MWOMDHX	Hampton Inn Middletown, OH
MXPSLGI	Hilton Garden Inn Milan Malpensa,Italy
MYRAPGI	Hilton Garden Inn Myrtle Beach/Coastal Grand Mall, SC
MYRBHHH	Hilton Myrtle Beach Resort
MYRCCHX	Hampton Inn Myrtle Beach-Broadway @ The Beach, SC
MYRESES	Embassy Suites by Hilton Myrtle Beach
MYRHPHX	Hampton Inn North Myrtle Beach Harbourgate
MYRKPES	Kingston Plantation Condos
MYRMIHX	Hampton Inn Murrells Inlet, SC
MYRNOHX	Hampton Inn Myrtle Beach Northwood
MYROFHX	Hampton Inn & Suites Myrtle Beach Oceanfront
MYRRPHH	Hilton Royale Palms
MYRTTGV	Ocean 22 by Hilton Grand Vacations
MYRWEHX	Hampton Inn Myrtle Beach West
MYSMHHF	Hilton Mystic
MYVOHHX	Hampton Inn Marysville
NAGHITW	Hilton Nagoya
NAMHIHI	Hilton Namhae Golf and Spa Resort
NAMIDHX	Hampton Inn and Suites Nampa @ Idaho Center
NANHIHI	Hilton Fiji Beach Resort & Spa
NANSIDI	DoubleTree Resort by Hilton Fiji - Sonaisali Island
NAPHIHF	Hilton Lisle-Naperville
NAPVLES	Embassy Suites by Hilton Napa Valley
NASHIHH	British Colonial Hilton Nassau
NATCZHX	Hampton Inn and Suites Natchez, MS
NAVDTDI	DoubleTree by Hilton Avanos - Cappadocia
NBFELHX	Hampton Inn and Suites New Braunfels, TX
NBOHITW	Hilton Nairobi
NBRNCHX	Hampton Inn New Bern
NBYHNHN	Hilton Newbury Centre
NBYNBHN	Hilton Newbury North
NBYSCHX	Hampton Inn Newberry Opera House
NCLGIGI	Hilton Garden Inn Sunderland, United Kingdom
NCLHIHI	Hilton Newcastle Gateshead
NCLHXHX	Hampton Inn Newcastle
NCLNADI	DoubleTree by Hilton Newcastle International Airport
NCTLAHX	Hampton Inn Natchitoches
NDJHIHI	Hilton NDjamena Africa
NEHHHHX	Hampton Inn Heath/Newark
NEWCHHX	Hampton Inn & Suites Wilmington/Christiana De
NEWDEES	Embassy Suites by Hilton Newark-Wilmington South
NEWHWHW	Homewood Suites Newark-Wilmington South
NEWNEHN	Hilton Newport
NIBLAHX	Hampton Inn and Suites New Iberia, LA
NICFLHX	Hampton Inn Niceville/Eglin AFB
NICHITW	Hilton Cyprus
NICLEHI	Hilton Park Nicosia
NIRBVHX	Hampton Inn Beeville, TX
NOCNHHX	Hampton Inn and Suites North Conway, NH
NORNHDT	DoubleTree by Hilton North Redington Beach
NOULPHI	Hilton Noumea La Promenade Residences, New Caldonia
NPHOHHX	Hampton Inn New Philadelphia
NPTMIHW	Homewood Suites by Hilton Newport Middletown, RI
NPTSKHX	Hampton Inn South Kingstown, RI
NRTHIHI	Hilton Tokyo Narita Airport
NUECCHX	Hampton by Hilton Nuremberg City Centre
NUEHIHI	Hilton Nuremberg
NUQCAHX	Hampton Inn and Suites Mountain View/Silicon Valley, CA
NWBMSHX	Hampton Inn and Suites Grenada, MS
NWCOHHX	Hampton Inn Newcomerstown
NWKBDDT	DoubleTree by Hilton Newark Fremont
NWKHSHX	Hampton Inn and Suites Newark/Harrison Riverwalk
NWKHWHW	Homewood Suites by Hilton Newark-Fremont
NWKNJHX	Hampton Inn Newark Airport
NYCAPHX	Hampton Inn New York-JFK Apt(Jamaica/Queens)
NYCBOHX	Hampton Inn Brooklyn/Downtown, NY
NYCBPDT	DoubleTree by Hilton New York City - Financial District
NYCCHGI	Hilton Garden Inn New York/Manhattan-Chelsea
NYCCICI	Conrad New York, NY
NYCCLDT	DoubleTree by Hilton New York City - Chelsea
NYCCSHX	Hampton Manhattan Chelsea
NYCDTDT	New York City-Metropolitan Hotel, NY
NYCEMHX	Hampton Inn Manhattan-35th Street/Empire State Bldg, NY
NYCETGI	Hilton Garden Inn New York Mid-Town Park Avenue
NYCFDHF	Hilton New York Fashion District
NYCHSHX	Hampton Manhattan Madison Square Garden
NYCJEHX	Hampton Inn Jericho/Westbury, NY
NYCJFHF	Hilton New York JFK Airport, NY
NYCLAHX	Hampton New York LaGuardia Airport
NYCMAHX	Hampton Manhattan Times Square South
NYCMDHF	Hilton Manhattan East
NYCMEGI	Hilton Garden Inn New York/Manhattan-Midtown East
NYCMHHX	Hampton Inn Manhattan-SoHo, NY
NYCMLHH	Hilton Millenium
NYCMMHW	Homewood Suites New York/Midtown Manhattan Times Sq-South
NYCMNHX	Hampton Inn Manhattan/Downtown-Financial District
NYCMRHX	Hampton Inn Harriman/Woodbury, NY
NYCMTHX	Hampton Inn Manhattan Times Square North
NYCMWGI	Hilton Garden Inn Times Square
NYCNADT	DoubleTree by Hilton Nanuet
NYCNHHH	New York Hilton Midtown
NYCSIHX	Hampton Inn and Suites Staten Island, NY
NYCSPHX	Hampton Manhattan Seaport Financial District
NYCSQDT	DoubleTree by Hilton New York-Times Square South
NYCSSGI	Hilton Garden Inn New York Times Square Central
NYCTFGI	Hilton Garden Inn New York  West 35th St
NYCTRGI	Hilton Garden Inn New York Tribeca
NYCTSHF	Hilton Times Square
NYCUNHX	Hampton Inn Manhattan United Nations
NYCWAWA	The Waldorf Astoria New York
NYCWFGI	Hilton Garden Inn Central Park South
NYCWTWA	The Waldorf Towers
NYCYNHX	Hampton Inn Yonkers
NYTHZHI	Hilton Nay Pyi Taw, Myanmar
OAJABHX	Hampton Inn and Suites Atlantic Beach, NC
OAJDTDT	DoubleTree by Hilton Atlantic Beach
OAJNCHX	Hampton Inn and Suites Jacksonville, NC
OAJSWHX	Hampton Inn and Suites Swansboro/Camp Lejeune, NC
OAKACDT	DoubleTree by Hilton Napa Valley/American Canyon Htl & Spa
OAKAMHX	Hampton Inn and Suites Oakland Airport/Alameda, CA
OAKFFHW	Homewood Suites by Hilton Fairfield-Napa Valley Area
OAKFHGI	Hilton Garden Inn Fairfield
OAKHIHH	Hilton Oakland Airport
OAKSLGI	Hilton Garden Inn Oakland/San Leandro
OAKUCHX	Hampton Inn Union City, CA
OALHIHF	Hilton Chicago/Oak Lawn, IL
OBEFLHX	Hampton Inn Okeechobee, FL
OBXNCHX	Hampton Inn and Suites Outer Banks/Corolla
OCEBSHX	Hampton Inn and Suites Ocean City/Bayfront-Conv Ctr, MD
OCFCYHX	Hampton Inn Crystal River, FL
OCFHWHW	Homewood Suites by Hilton Ocala at Heath Brook
OCFOHHF	Hilton Ocala-Silver Springs
OCFSOHX	Hampton Inn & Suites Ocala/Belleview, FL
OCFSWHX	Hampton Inn and Suites Ocala, FL
OCHCEHX	Hampton Inn and Suites Center, TX
OCHHSHX	Hampton Inn and Suites Nacogdoches, TX
ODETXHX	Hampton Inn Odessa, TX
OFKNEHX	Hampton Inn-Norfolk,NE
OGDFMHX	Hampton Inn and Suites Salt Lake City/Farmington, UT
OGDUTHX	Hampton Inn and Suites Ogden
OGDWBGI	Hilton Garden Inn Ogden, UT
OGGHOWA	Ho'olei at Grand Wailea
OGSPCHX	Hampton Inn Potsdam/Canton, NY
OKANADI	DoubleTree by Hilton Naha, Japan
OKAOCHI	Hilton Okinawa Chatan Resort, Japan
OKCADHX	Hampton Inn and Suites Ada, OK
OKCAHGI	Hilton Garden Inn Oklahoma City Airport
OKCARDT	DoubleTree by Hilton Oklahoma City Airport
OKCATHX	Hampton Inn and Suites Oklahoma City Airport, OK
OKCBKHW	Homewood Suites by Hilton Oklahoma City - Bricktown, OK
OKCBTHX	Hampton Inn and Suites Oklahoma City - Bricktown, OK
OKCEDHX	Hampton Inn Oklahoma City/Edmund
OKCESES	Embassy Suites by Hilton Norman - Hotel & Conference Center
OKCMDGI	Hilton Garden Inn Oklahoma City Midtown, OK
OKCMRES	Embassy Suites by Hilton Oklahoma City-Will Rogers World AP
OKCMWHX	Hampton Inn Oklahoma City/Tinker AFB
OKCNMHX	Hampton Inn Norman
OKCNOGI	Hilton Garden Inn Norman, OK
OKCNTHX	Hampton Inn Oklahoma City Northwest
OKCOKES	Embassy Suites by Hilton Oklahoma City Downtown/Medical Ctr
OKCPVHX	Hampton Inn and Suites Pauls Valley, OK
OKCQUGI	Hilton Garden Inn Oklahoma City North/Quail Springs, OK
OKCSAGI	Hilton Garden Inn Oklahoma City Bricktown, OK
OKCSKHF	The Skirvin Hilton Oklahoma City
OKCSOHX	Hampton Inn and Suites Oklahoma City-South, OK
OKCWEHW	Homewood Suites by Hilton Oklahoma City West, OK
OKCYKHX	Hampton Inn Oklahoma City/Yukon
OLBDTDI	DoubleTree by Hilton Olbia - Sardinia
OLBMSHX	Hampton Inn Olive Branch
OLMCWDT	DoubleTree by Hilton Olympia
OLNNYHX	Hampton Inn Olean
OMABVHX	Hampton Inn Bellevue, NE
OMACBHX	Hampton Inn Council Bluffs
OMACSHT	Home2 Suites by Hilton Omaha West
OMACVHH	Hilton Omaha
OMADMGI	Hilton Garden Inn Omaha Downtown/Old Market Area
OMADNHX	Hampton Inn and Suites Omaha/Dowtown, NE
OMADTES	Embassy Suites by Hilton Omaha-Downtown-Old Market
OMAEAGI	Hilton Garden Inn Omaha East/Council Bluffs, IA
OMAESES	Embassy Suites by Hilton Omaha - La Vista
OMAHDT	DoubleTree by Hilton Omaha-Downtown
OMAHWHW	Homewood Suites by Hilton Omaha/Downtown, NE
OMALVHX	Hampton Inn and Suites Omaha/La Vista, NE
OMAWDHX	Hampton Inn Omaha/West-Dodge Road (Old Mill), NE
OMAWEGI	Hilton Garden Inn Omaha West, NE
OMAWTHX	Hampton Inn Omaha/West, NE
OMRDTDI	DoubleTree by Hilton Oradea
ONAISDT	DoubleTree by Hilton Irvine-Spectrum
ONHNJHX	Hampton Inn Oneonta
ONTAPES	Embassy Suites by Hilton Ontario Airport
ONTBRHX	Hampton Inn and Suites Barrie, Ontario, CN
ONTBUHW	Homewood Suites Burlington, Ontario
ONTCLDT	DoubleTree by Hilton Claremont
ONTCUGI	Hilton Garden Inn Ontario/Rancho Cucamonga, CA
ONTHSHX	Hampton Inn and Suites Ontario, CA
ONTHWHW	Homewood Suites by Hilton Ontario/Rancho Cucamonga, CA
ONTNCHX	Hampton Inn and Suites Norco-Corona-Eastvale CA
ONTNPHX	Hampton Inn Napanee, Ontario, Canada
ONTODT	DoubleTree by Hilton Ontario Airport
OOLHIHI	Surfers Paradise Hilton
OOLREHI	Surfers Paradise Residences Hilton
ORBHHGI	Hilton Garden Inn Orange Beach
ORDCHGI	Hilton Garden Inn Chicago O'Hare Airport
ORDEVGI	Hilton Garden Inn Chicago North Shore/Evanston
ORDHRHH	Hilton Rosemont/Chicago OHare
ORDILHF	Hilton Bloomingdale Indian Lakes Resort
ORDLFGI	Hilton Garden Inn Lake Forest/Mettawa, IL
ORDMDHF	Hilton Suites Chicago-Downtown
ORDNWGI	Hilton Garden Inn Naperville/Warrenville, IL
ORDOEHF	Hilton Orrington/Evanston
ORDSIGI	Hilton Garden Inn Schaumburg, IL
ORDWBDT	DoubleTree Suites by Hilton Downers Grove
ORFAPHX	Hampton Inn and Suites Norfolk-Airport, VA
ORFBFHX	Hampton Inn and Suites Chesapeake-Battlefield Blvd., VA
ORFBNDT	DoubleTree by Hilton Virginia Beach
ORFBOGI	Hilton Garden Inn Virginia Beach Oceanfront, VA
ORFCHGI	Hilton Garden Inn Chesapeake Greenbrier
ORFCKHX	Hampton Inn and Suites Chesapeake-Chesapeake Square Mall
ORFCPHX	Hampton Inn Norfolk/Chesapeake
ORFEXHX	Hampton Inn and Suites Exmore/Eastern Shore, VA
ORFGLHX	Hampton Inn Gloucester, VA
ORFHAHX	Hampton Inn Hampton/Newport News, VA
ORFHSHX	Hampton Inn and Suites Newport News/Oyster Point
ORFHWHW	Homewood Suites by Hilton Chesapeake/Greenbrier, VA
ORFKHGI	Hilton Garden Inn Outer Banks/Kitty Hawk
ORFNADT	DoubleTree by Hilton Norfolk Airport, VA
ORFNBHX	Hampton Inn Norfolk Naval Base
ORFNTHW	Homewood Suites by Hilton Virginia Beach
ORFNWGI	Hilton Garden Inn Newport News
ORFOCHX	Hampton Inn Virginia Beach-Oceanfront North, VA
ORFOFHX	Hampton Inn Virginia Beach/Oceanfront South, VA
ORFSHGI	Hilton Garden Inn Suffolk Riverfront
ORFSMHX	Hampton Inn and Suites Smithfield, VA
ORFTCGI	Hilton Garden Inn Virginia Beach-Town Center
ORFVBHX	Hampton Inn Norfolk/Virginia Beach
ORFVHHF	Hilton Virginia Beach Resort
ORHDCGI	Hilton Garden Inn Devens Common
ORHLEDT	DoubleTree by Hilton Leominster
ORHMAHX	Hampton Inn Auburn, MA
ORKDTDT	DoubleTree by Hilton Oak Ridge
ORKHHHX	Hampton Inn Oak Ridge
ORLAHGI	Hilton Garden Inn Orlando Airport
ORLBCWA	Waldorf Astoria Orlando
ORLDWHH	Hilton Orlando Lake Buena Vista, FL
ORLHHHH	Hilton Orlando-Bonnet Creek Resort
ORLIHGI	Hilton Garden Inn Orlando Internat. Drive North
ORLINGV	Hilton Grand Vacations Suites on International Drive-Orlando
ORLLMGI	Hilton Garden Inn Orlando North/Lake Mary
ORLOCHH	Hilton Orlando Orange County Convention Center
ORLOEDT	DoubleTree by Hilton Orlando East - UCF Area
ORLSEGI	Hilton Garden Inn Orlando at Seaworld, FL
ORLSWGV	Hilton Grand Vacations Suites at SeaWorld Orlando
ORLUCGI	Hilton Garden Inn Orlando East/UCF Area, FL
ORMCBHX	Hampton Inn-Corby,United Kingdom
ORMNOHN	Hilton Northampton
ORQDTDT	DoubleTree by Hilton Norwalk
ORQNWGI	Hilton Garden Inn Norwalk, CT
ORYHITW	Hilton Paris Orly Airport
OSAHITW	Hilton Osaka
OSHGIGI	Hilton Garden Inn Oshkosh
OTMIAHX	Hampton Inn Ottumwa, IA
OTWILHX	Hampton Inn Ottawa/Starved Rock
OVBDTDI	DoubleTree by Hilton Novosibirsk
OWBDWHX	Hampton Inn and Suites Owensboro/Downtown-Waterfront, KY
OWBHHHX	Hampton Inn Owensboro South, KY
OXFHXHX	Hampton By Hilton Oxford
OXFUVHX	Hampton Inn Oxford/Miami University Area, OH
OXNCAES	Embassy Suites by Hilton Mandalay Beach Resort-Oxnard
OXNHSHX	Hampton Inn and Suites Camarillo
OXRCIHX	Hampton Inn Channel Islands Harbor, CA
OXRHWHW	Homewood Suites by Hilton Oxnard/Camarillo, CA
OXROHGI	Hilton Garden Inn Oxnard/Camarillo
PAEWAGI	Hilton Garden Inn Seattle North/Everett, WA
PAHCLHX	Hampton Inn and Suites Paducah, KY
PAHMYHX	Hampton Inn and Suites Murray, KY
PAOCRGI	Hilton Garden Inn Palo Alto, CA
PAOPAHW	Homewood Suites By Hilton - Palo Alto, CA
PARAHHI	Hotel Astor - Saint Honoré
PARISHX	Hampton Inn Paris, TX
PARLDHI	Hilton Paris La Defense
PAROPHI	Hilton Paris Opera
PASPAGI	Hilton Garden Inn Arcadia/Pasadena Area
PASPHHF	Hilton Pasadena
PAWSCHX	Hampton Inn Pawley's Island, SC
PBFMOHX	Hampton Inn Monticello, AR
PBFOLHX	Hampton Inn & Suites Pine Bluff
PBIAADT	DoubleTree by Hilton West Palm Beach Airport
PBIAHHF	Hilton Palm Beach-Airport
PBIBRES	Embassy Suites by Hilton West Palm Beach Airport
PBICAHX	Hampton Inn West Palm Beach-Central/Airport
PBICTHW	Homewood Suites by Hilton West Palm Beach
PBIGDGI	Hilton Garden Inn Palm Beach Gardens, FL
PBIHHHX	Hampton Inn Palm Beach Gardens
PBIHWHW	Homewood Suites by Hilton Palm Beach Gardens, FL
PBIJBHX	Hampton Inn Jupiter/Juno Beach
PBILWHX	Hampton Inn West Palm Beach/Lake Worth-Turnpike, FL
PBIMPDT	DoubleTree by Hilton Palm Beach Gardens
PBIPBGI	Hilton Garden Inn West Palm Beach Airport, FL
PBIPGES	Embassy Suites by Hilton Palm Beach Gardens - PGA Boulevard
PBISIHF	Hilton Singer Island Oceanfront/Palm Beaches, FL
PBIVCHX	Hampton Inn West Palm Beach/Florida Turnpike
PBIWPHH	Hilton West Palm Beach
PCTDTDT	DoubleTree by Hilton Princeton
PCTINHX	Hampton Inn Princeton, IN
PDLCAHX	Hampton Inn and Suites Palmdale, CA
PDLHWHW	Homewood Suites by Hilton Lancaster, CA
PDLLCHX	Hampton Inn and Suites Lancaster, CA
PDXAHGI	Hilton Garden Inn Portland Airport
PDXAPHX	Hampton Inn Portland Airport, OR
PDXBHGI	Hilton Garden Inn Portland/Beaverton
PDXBTHW	Homewood Suites by Hilton Hillsboro/Beaverton, OR
PDXBVES	Embassy Suites by Hilton Portland-Washington Square
PDXCLHX	Hampton Inn Portland/Clackamas
PDXCRDT	DoubleTree by Hilton Beaverton
PDXESES	Embassy Suites by Hilton Portland-Airport
PDXHEHX	Hampton Inn and Suites Hillsboro, OR
PDXHTES	Embassy Suites by Hilton Portland/Hillsboro
PDXLOGI	Hilton Garden Inn Portland/Lake Oswego
PDXORHX	Hampton Inn Portland/Gresham
PDXPHHH	Hilton Portland
PDXPSES	Embassy Suites by Hilton Portland-Downtown
PDXPTDT	DoubleTree by Hilton Portland Tigard
PDXVAHH	Hilton Vancouver Washington
PDXVEHX	Hampton Inn and Suites Portland/Vancouver, WA
PECTYHX	Hampton Inn Pell City
PEEGIGI	Hilton Garden Inn Perm
PENMBDI	Doubletree by Hilton Penang, Malaysia
PENORHX	Hampton Inn Pendleton, OR
PERFLHX	Hampton Inn - Perry, FL
PERHITW	Parmelia Hilton Perth Hotel
PETHITW	Hilton Petaling Jaya
PETMIHX	Hampton Inn and Suites Petoskey
PFNBEHX	Hampton Inn Panama City Beach
PFNCMHX	Hampton Inn Panama City Mall
PFNPCGI	Hilton Garden Inn Panama City Fl+++
PFNPPHX	Hampton Inn and Suites Panama City Beach/Pier Park Area, FL
PGFHSHX	Hampton Inn and Suites Pigeon Forge Music Road
PGLMPHX	Hampton Inn Moss Point, MS
PGLPGGI	Hilton Garden Inn Pascagoula
PGVGVHX	Hampton Inn Greenville,  NC
PGVNCHF	Hilton Greenville
PHFCCES	Embassy Suites by Hilton Hampton Conv. Center
PHFHCGI	Hilton Garden Inn Hampton Coliseum Central, VA
PHFHHHX	Hampton Inn Newport News-Yorktown, VA
PHFWBHX	Hampton Inn and Suites Williamsburg-Historic Area, VA
PHFWHGI	Hilton Garden Inn Williamsburg
PHLAPES	Embassy Suites by Hilton Philadelphia-Airport
PHLATHX	Hampton Inn Philadelphia Intl Airport
PHLBLDT	DoubleTree by Hilton Philadelphia
PHLCAHW	Homewood Suites Philadelphia City Ave
PHLCCHT	Home2 Suites Philadelphia Convention Center
PHLCVHX	Hampton Philadelphia Convention Center
PHLDADT	DoubleTree by Hilton Philadelphia Airport
PHLDOGI	Hilton Garden Inn Dover, DE
PHLDTES	Embassy Suites by Hilton Philadelphia-Center City
PHLEXGI	Hilton Garden Inn Exton/West Chester
PHLFRDT	DoubleTree Suites by Hilton Mt. Laurel
PHLFWGI	Hilton Garden Inn Philadelphia/Ft. Washington
PHLFZHX	Hampton Inn Philadelphia/Great Valley/Malvern, PA
PHLGHDT	DoubleTree Suites by Hilton Philadelphia West
PHLGIGI	Hilton Garden Inn Philadelphia City Center
PHLGVHW	Homewood Suites by Hilton Philadelphia/Great Valley
PHLHWHW	Homewood Suites by Hilton Philadelphia/Valley Forge, PA
PHLIDHH	Hilton Inn at Penn
PHLKPHX	Hampton Inn Philadelphia/King of Prussia (Valley Forge), PA
PHLKSGI	Hilton Garden Inn Kennett Square
PHLLIHX	Hampton Inn Limerick-Philadelphia, PA
PHLMTGI	Hilton Garden Inn Mt. Laurel, NJ
PHLMXHX	Hampton Inn and Suites Montgomeryville, PA
PHLPHHF	Hilton Philadelphia City Avenue
PHLPMHX	Hampton Inn Philadelphia/Plymouth Meeting
PHLPNHH	Hilton Philadelphia Penns Landing
PHLPOGI	Hilton Garden Inn Valley Forge/Oaks, PA
PHLQQQQ	The Logan Phildelaphia, Curio Collection by Hilton
PHLSTHX	Hampton Inn and Suites Philadelphia Bensalem, PA
PHLUPHW	Homewood Suites by Hilton University City Philadelphia, PA
PHLVFDT	DoubleTree by Hilton Philadelphia - Valley Forge
PHLVLES	Embassy Suites by Hilton Philadelphia Valley Forge
PHLVYHX	Hampton Inn and Suites Valley Forge/Oaks
PHLWAHW	Homewood Suites by Hilton Doylestown, PA
PHNTEDT	DoubleTree by Hilton Port Huron
PHXADHW	Homewood Suites by Hilton Phoenix-Avondale
PHXAGGI	Hilton Garden Inn Phoenix Airport, Az
PHXAHHF	Hilton Phoenix-Airport
PHXAMHX	Hampton Inn Phoenix Anthem
PHXANGI	Hilton Garden Inn Phoenix Airport North
PHXAPHX	Hampton Inn Phoenix Airport North
PHXASHW	Homewood Suites by Hilton Phoenix Airport South
PHXAVGI	Hilton Garden Inn Phoenix West/Avondale
PHXBMWA	Arizona Biltmore
PHXCBES	Embassy Suites by Hilton Phoenix-Biltmore
PHXCDHW	Homewood Suites by Hilton Phoenix/Chandler
PHXCHHF	Hilton Phoenix/Chandler
PHXCLHW	Homewood Suites by Hilton Phoenix/Chandler Fashion Center
PHXCNHX	Hampton Inn Phoenix/Chandler
PHXCRHX	Hampton Inn and Suites Phoenix/Chandler-Spectrum, AZ
PHXDOGI	Hilton Garden Inn Phoenix Downtown, AZ
PHXEHHX	Hampton Inn Phoenix - Biltmore, AZ
PHXFVDT	DoubleTree Suites by Hilton Phoenix-Gateway Center
PHXGDHX	Hampton Inn Phoenix/Gleandale
PHXGLHX	Hampton Inn and Suites Phoenix Glendale/Westgate, AZ
PHXGTHX	Hampton Inn and Suites Phoenix/Gilbert, AZ
PHXGYHX	Hampton Inn and Suites Goodyear
PHXHPHX	Hampton Inn and Suites Phoenix I-17/Happy Valley, AZ
PHXHVGI	Hilton Garden Inn Phoenix North/Happy Valley, AZ
PHXHWHW	Homewood Suites by Hilton Phoenix/Biltmore
PHXHYHW	Homewood Suites by Hilton Phoenix North/Happy Valley
PHXMDGI	Hilton Garden Inn - Phoenix/Midtown
PHXMPDT	DoubleTree by Hilton Phoenix-Tempe, AZ
PHXNOES	Embassy Suites by Hilton Phoenix-North
PHXPPHS	Hilton Suites Phoenix
PHXPRHW	Homewood Suites by Hilton Phoenix/Metro Center
PHXPVES	Embassy Suites by Hilton Phoenix - Scottsdale
PHXRSQQ	BOULDERS RESORT, CURIO COLLECTION BY HILTON
PHXSJDT	DoubleTree by Hilton Paradise Valley Resort
PHXSPPR	Pointe Hilton Squaw Peak Resort
PHXSRHX	Hampton Inn and Suites Surprise, AZ
PHXSTDT	DoubleTree by Hilton Phoenix-Gilbert
PHXSUHX	Hampton Inn and Suites Phoenix/Tempe - ASU Area, AZ
PHXTCPR	Pointe Hilton Tapatio Cliffs Resort
PHXTHES	Embassy Suites by Hilton Phoenix Airport at 24th Street
PHXTPES	Embassy Suites by Hilton Phoenix - Tempe
PHXUTHX	Hampton Inn Phoenix Midtown
PIAEAHX	Hampton Inn Peoria East
PIAESES	Embassy Suites by Hilton East Peoria
PICTNHX	Hampton Inn Pickwick Dam @ Shiloh Falls
PIECAHF	Hilton Carillon Park Hotel
PIECBHF	Hilton Clearwater Beach
PIEFLHX	Hampton Inn St. Petersburg
PIEHSHX	Hampton Inn and Suites St. Petersburg Downtown
PIEWEHX	Hampton Inn and Suites Peoria-West, IL
PIHIDHX	Hampton Inn and Suites Pocatello, ID
PIKDTDT	DoubleTree by Hilton Baltimore North/Pikesville, MD
PISNJES	Embassy Suites by Hilton Piscataway-Somerset
PITAPHX	Hampton Inn Pittsburgh Airport
PITARDT	DoubleTree by Hilton Pittsburgh Airport
PITATES	Embassy Suites by Hilton Pittsburgh-International Airport
PITBVHX	Hampton Inn Pittsburgh - Bridgeville, PA
PITCRGI	Hilton Garden Inn Pittsburgh/Cranberry, PA
PITDNHX	Hampton Inn and Suites Pittsburgh, PA
PITDTDT	DoubleTree by Hilton Pittsburgh-Downtown, PA
PITFAGI	Hilton Garden Inn Pittsburgh Downtown
PITGNHX	Hampton Inn Pittsburgh/Greentree
PITGTDT	DoubleTree by Hilton Pittsburgh-Green Tree, PA
PITLTHT	Home2 Suites Pittsburgh Cranberry, PA
PITMADT	DoubleTree by Hilton Pittsburgh Cranberry
PITMCHT	Home2 Suites Pittsburgh/Mccandless, PA
PITMKHX	Hampton Inn Pittsburg McKnight Road
PITMLHX	Hampton Inn & Suites Pittsburgh/Meadow Lands,PA
PITMPDT	DoubleTree by Hilton Pittsburgh-Meadow Lands
PITMRDT	DoubleTree by Hilton Pittsburgh/Monroeville Conv Cntr, PA
PITMVHX	Hampton Inn Pittsburg/Monroeville
PITOKHX	Hampton Inn Pittsburgh University Center
PITRTHW	Homewood Suites Pittsburgh Airport/Robinson Mall Area
PITSBHW	Homewood Suites Pittsburgh-Southpointe
PITSMES	Embassy Suites by Hilton Pittsburgh Downtown
PITSPGI	Hilton Garden Inn Pittsburg/Southpointe
PITUCGI	Hilton Garden Inn Pittsburgh-University Place, PA
PITWHHX	Hampton Inn & Suites Pittsburgh/West Homestead
PITWMHX	Hampton Inn Pittsburgh/West Mifflin
PITWRHX	Hampton Inn Pittsburgh/Cranberry
PKBDOHX	Hampton Inn and Suites Parkersburg Downtown, WV
PKBWVHX	Hampton Inn Parkersburg-Mineral Wells, WV
PLBNYHX	Hampton Inn and Suites Plattsburgh, NY
PLEPCDT	DoubleTree by Hilton Pleasanton at the Club
PLKBHHX	Hampton Inn Branson/Branson Hills, MO
PLMDRES	Embassy Suites by Hilton Palm Desert Resort
PLMHSHX	Hampton Inn-Palm Desert,CA
PLMHWHW	Homewood Suites by Hilton Palm Desert, CA
PMDCCES	Embassy Suites by Hilton Palmdale
PMIHFHI	Hilton Sa Torre Mallorca Resort
PMLNJHX	Hampton Inn Philadelphia/Mt. Laurel
PNCHIHH	Hilton Ponce Golf & Casino Resort
PNQCHDI	DoubleTree by Hilton Pune Chinchwad, India
PNQCICI	Conrad Pune, India
PNQSHHI	Hilton Shillim Estate Retreat & Spa, India
PNSAPHX	Hampton Inn Pensacola Airport
PNSCPGI	Hilton Garden Inn Pensacola Airport/Medical Center
PNSFLHX	Hampton Inn Pensacola
PNSGBHX	Hampton Inn and Suites Pensacola/Gulf Breeze, FL
PNSHSHX	Hampton Inn and Suites Pensacola-Univ.Mall
PNSHWHW	Homewood Suites by Hilton Pensacola Airport-Cordova Mall, FL
PNSLWHX	Hampton Inn and Suites Pensacola
PNSNVHX	Hampton Inn and Suites Navarre, FL
PNSPEHF	Hilton Pensacola Beach Gulf Front
PNXDSHX	Hampton Inn and Suites Denison, TX
PORINHX	Hampton Inn Portage
POSHIHH	Trinidad Hilton & Conference Center
POUKGHX	Hampton Inn Kingston, NY
POUNYHX	Hampton Inn Poughkeepsie
PPTBNHI	Hilton Bora Bora Nui Resort & Spa
PPTMLHI	Hilton Moorea Lagoon Resort & Spa
PQIMAHX	Hampton Inn Presque Isle, Maine
PRBCAHX	Hampton Inn and Suites Paso Robles
PRCHHHX	Hampton Inn Prescott
PRCVLHX	Hampton Inn and Suites Prescott Valley, AZ
PRGHITW	Hilton Prague
PRGOTHI	Hilton Prague Old Town
PRIWVHX	Hampton Inn Princeton, WV
PRLBHHF	Hilton Pearl River
PRNDVHW	Homewood Suites by Hilton Dover - Rockaway
PRNHCHX	Hampton Inn Parsippany
PRNHOHX	Hampton Inn and Suites Parsippany, NJ
PRNNJES	Embassy Suites by Hilton Parsippany
PRYGAHX	Hampton Inn Perry, GA
PSCKEGI	Hilton Garden Inn Tri-Cities/Kennewick
PSCRLHX	Hampton Inn Richland/Tri-Cities
PSLHWHW	Homewood Suites by Hilton Port St. Lucie-Tradition, FL
PSLWEHX	Hampton Inn and Suites Port St. Lucie West
PSMDNHX	Hampton Inn Portsmouth/Downtown, NH
PSMDOHX	Hampton Inn Dover, NH
PSMDVHW	Homewood Suites by Hilton Dover, NH
PSMHWHW	Homewood Suites Portsmouth
PSMNHHX	Hampton Inn Portsmouth Central, NH
PSMSUGI	Hilton Garden Inn Chesapeake/Suffolk, VA
PSNTXHX	Hampton Inn and Suites Palestine, TX
PSPDPDT	DoubleTree by Hilton Golf Resort Palm Springs
PSPLQWA	La Quinta Resort & Club
PSPPSHF	Hilton Palm Springs
PSPRMGI	Hilton Garden Inn Palm Springs/Rancho Mirage
PTATXHX	Hampton Inn and Suites Port Arthur, TX
PTBHPHX	Hampton Inn Petersburg/Hopewell
PTBVAHX	Hampton Inn Petersburg/Ft. Lee
PTCFLHX	Hampton Inn Port Charlotte
PTHMIHX	Hampton Inn Port Huron
PTNHHHX	Hampton Inn Princeton, NJ
PTNHWHW	Homewood Suites by Hilton Princeton, NJ
PTYDTDI	DoubleTree by Hilton Panama City - El Carmen
PTYHFHH	Hilton Panama City
PTYHXHX	Hampton Inn Panama City
PTYPPGI	Hilton Garden Inn Panama
PTYTPWA	Waldorf Astoria Panama City
PUBCCHX	Hampton Inn Canon City, CO
PUBELHX	Hampton Inn and Suites Pueblo, CO
PUBHSHX	Hampton Inn & Suites Pueblo - Southgate
PUBLJHX	Hampton Inn La Junta, CO
PVDCUQQ	Providence Biltmore, Curio Collection By Hilton
PVDGIGI	Hilton Garden Inn Providence Airport/Warwick
PVDPRHF	Hilton Providence
PVDSFHX	Hampton Inn and Suites Smithfield, RI
PVDWYHX	Hampton Inn and Suites Providence, RI
PVENJHX	Hampton Inn Pennsville
PVGPAHX	Hampton Inn Pine Grove, PA
PVLNCHX	Hampton Inn and Suites Charlotte/Pineville
PVRPVHF	Hilton Puerto Vallarta
PVUHHHX	Hampton Inn Provo
PVULIHX	Hampton Inn Lehi-Thanksgiving Point, UT
PVUORHX	Hampton Inn and Suites Provo/Orem
PWMAPES	Embassy Suites by Hilton Portland
PWMBAHX	Hampton Inn Bath (Brunswick Area), ME
PWMDHGI	Hilton Garden Inn Portland Waterfront, Me
PWMDTHX	Hampton Inn Portland Downtown Waterfront, ME
PWMFDGI	Hilton Garden Inn Freeport Downtown, ME
PWMFPHX	Hampton Inn Freeport/Brunswick
PWMHWHW	Homewood Suites by Hilton Portland
PWMLAHX	Hampton Inn Lewiston/Auburn, ME
PWMMEHX	Hampton Inn Portland Airport, ME
PWMMMDT	DoubleTree by Hilton Portland, Me
PWMPAGI	Hilton Garden Inn Portland Airport, ME
PWMSCHX	Hampton Inn Saco/Biddeford
PWTWAHX	Hampton Inn and Suites, Bremerton, WA
PYMHSHX	Hampton Inn and Suites Plymouth, MA
PYMMAGI	Hilton Garden Inn Plymouth
QKBVRDT	DoubleTree by Hilton Breckenridge
QMZCHTW	Hilton Mainz City
QMZHITW	Hilton Mainz
QORHXHX	Hampton Inn Ordu
QQYTGHX	Hampton Inn York
QRODTDT	DoubleTree by Hilton Queretaro
QROHTHX	Hampton Inn Queretaro, Mexico
QROPIGI	Hilton Garden Inn Queretaro
QROSJHX	Hampton Inn San Juan Del Rio, MX
QROSLHT	Home2 Suites by Hilton Queretaro, Mexico
QUAPAHX	Hampton Inn Quakertown
QUIFLHX	Hampton Inn Quincy, FL
QUIHIHF	Hilton Colon Quito
RALRWHX	Hampton Inn and Suites Riverside/Corona East,  CA
RAPGIGI	Hilton Garden Inn Rapid City, SD
RAPHAHX	Hampton Inn Rapid City
RAPSSQQ	Hotel Alex Johnson Rapid City, Curio Collection by Hilton
RAYMAHX	Hampton Inn Raynham/Taunton, MA
RBHDEHX	Hampton Inn Rehoboth Beach
RBLCAHX	Hampton Inn and Suites Red Bluff, CA
RCHKYHX	Hampton Inn Richmond
RCKSCHX	Hampton Inn Rock Hill
RCTCAHX	Hampton Inn and Suites Ridgecrest, CA
RDDCAHX	Hampton Inn and Suites Redding, CA
RDDREGI	Hilton Garden Inn Redding
RDGDTDT	DoubleTree by Hilton Reading+++
RDGWMHX	Hampton Inn Reading/Wyomissing
RDMBEHX	Hampton Inn and Suites Bend, OR
RDMBOGI	Hilton Garden Inn Bend, OR
RDMFADT	DoubleTree by Hilton Bend
RDUACES	Embassy Suites by Hilton Raleigh-Durham Airport/Brier Creek
RDUAHGI	Hilton Garden Inn Raleigh -Durham Airport
RDUANHX	Hampton Inn and Suites Raleigh Airport/North , NC
RDUAPES	Embassy Suites by Hilton Raleigh-Durham-Research Triangle E
RDUAWHX	Hampton Inn and Suites Raleigh/Crabtree Valley, NC
RDUAYDT	DoubleTree by Hilton Raleigh/Cary
RDUCHHX	Hampton Inn and Suites Chapel Hill/Druham
RDUCLHX	Hampton Inn Raleigh/Clayton
RDUCMES	Embassy Suites by Hilton Raleigh/Crabtree
RDUCOHX	Hampton Inn and Suites Chapel Hill-Carrboro/Downtown, NC
RDUCTHW	Homewood Suites by Hilton Raleigh/Crabtree Valley
RDUCUQQ	The Franklin Hotel Chapel Hill, Curio Collection By Hilton+++
RDUCYHX	Hampton Inn and Suites Raleigh/Cary
RDUDADT	DoubleTree by Hilton Raleigh Durham Airport
RDUDHHF	Hilton Durham
RDUDMHW	Homewood Suites by Hilton Raleigh-Durham Aprt @ RTP
RDUDNDT	DoubleTree by Hilton Brownstone-University
RDUDWHX	Hampton Inn and Suites Raleigh Downtown, NC
RDUGIGI	Hilton Garden Inn Raleigh-Durham/Research Triangle Park
RDUGNHX	Hampton Inn Raleigh/Garner
RDUHHHX	Hampton Inn Raleigh Capital Blvd. North
RDUHSHX	Hampton Inn and Suites Holly Springs, NC
RDUHWHW	Homewood Chapel Hill/Durham
RDUIIDT	DoubleTree Suites by Hilton Raleigh-Durham
RDUMCGI	Hilton Garden Inn Durham/University Medical Center
RDUMVHX	Hampton Inn Raleigh Durham Airport
RDUNCHX	Hampton Inn Raleigh North
RDUNEGI	Hilton Garden Inn Raleigh Triangle Town Center, NC
RDUNHHF	Hilton North Raleigh
RDUNOHX	Hampton Inn and Suites Durham-North I-85, NC
RDURCGI	Hilton Garden Inn Raleigh-Cary, NC
RDUSPGI	Hilton Garden Inn Durham Southpoint, NC
RDUWFHX	Hampton Inn Raleigh/Town of Wake Forest
RDUWLHX	Hampton Inn Wilson-Downtown, NC
REXHAHX	Hampton Inn Reynosa, Mexico
RFDAGHX	Hampton Inn DeKalb (Near the University), IL
RFDILGI	Hilton Garden Inn Rockford, IL
RFDOHHX	Hampton Inn Richfield
RFPNJHX	Hampton Inn Ridgefield Park
RHLCTHX	Hampton Inn Rocky Hill/Harford
RICAIGI	Hilton Garden Inn Richmond Airport, VA
RICAPHW	Homewood Suites by Hilton Richmond Airport
RICARHX	Hampton Inn Richmond-Airport, VA
RICCHHX	Hampton Inn Chester
RICCOHX	Hampton Inn Petersburg-Southpark Mall
RICCSHW	Homewood Suites by Hilton Chester
RICDNES	Embassy Suites by Hilton Richmond-The Commerce Center
RICDOHW	Homewood Suites by Hilton Richmond-Downtown
RICEMHX	Hampton Inn & Suites Richmond - Downtown, VA
RICGLHX	Hampton Inn and Suites Richmond/Glenside, VA
RICIBGI	Hilton Garden Inn Richmond Innsbrook
RICKSDT	DoubleTree by Hilton Richmond Midlothian
RICMDHX	Hampton Inn Richmond Midlothian Turnpike
RICMVHX	Hampton Inn Richmond/Mechanicsville
RICPCHX	Hampton Inn Richmond Southwest
RICRDHH	Hilton Richmond Downtown
RICSOHX	Hampton Inn Richmond-South, VA
RICSPGI	Hilton Garden Inn Richmond South/Southpark, VA
RICVCHX	Hampton Inn and Suites Richmond-Virginia Ctr
RICWEHX	Hampton Inn Richmond West
RICWSHF	Hilton Richmond Hotel & Spa Short Pump Town Center
RICWTHW	Homewood Suites by Hilton Richmond West End - Innsbrook
RIDHSHX	Hampton Inn and Suites Richmond, IN
RIFUTHX	Hampton Inn Richfield, UT
RILCOHX	Hampton Inn and Suites Rifle, CO
RIOABHH	Hilton Barra Rio De Janeiro
RIWWYHX	Hampton Inn and Suites Riverton, WY
RKFILHX	Hampton Inn Rockford
RKHRHGI	Hilton Garden Inn Rock Hill
RKSHHHX	Hampton Inn Rock Springs, WY
RKSWYHW	Homewood Suites by Hilton Rock Springs, WY
RKTAHHI	Hilton Al Hamra Beach & Golf Resort
RKTDTDI	DoubleTree by Hilton Ras Al Khaimah
RKTMIDI	DoubleTree by Hilton Resort  & Spa Marjan Island
RKTRSHI	Hilton Ras Al Khaimah Resort & Spa
RKTWAWA	Waldorf Astoria Ras Al Khaimah
RLBKDT	DoubleTree by Hilton Bakersfield
RLDUDT	DoubleTree by Hilton Durango
RLDVDT	DoubleTree by Hilton Denver
RLDWAHW	Homewood Suites by Hilton Richland, WA
RLLCDT	DoubleTree by Hilton Portland-Lloyd Center
RLMVDT	DoubleTree by Hilton Missoula/Edgewater
RLSADT	DoubleTree by Hilton Sacramento, CA
RLSCDT	DoubleTree by Hilton Sonoma Wine Country
RMEBHHX	Hampton Inn Rome, NY
RMFHIHI	Hilton Marsa Alam Nubian Resort
RMGAVHX	Hampton Inn Adairsville, GA
RMGHHHX	Hampton Inn Rome, GA
RNOGIGI	Hilton Garden Inn Reno, NV
RNOHSHX	Hampton Inn and Suites Reno, NV
RNOHWHW	Homewood Suites by Hilton Reno, NV
ROAAPHX	Hampton Inn & Suites Roanoke Airport,VA
ROAGIGI	Hilton Garden Inn Roanoke
ROAHHHX	Hampton Inn Roanoke Hollins
ROASAHX	Hampton Inn Salem/Roanoke Area, VA
ROASWDT	Hotel Roanoke & Conference Center
ROCBPHX	Hampton Inn Brockport, NY
ROCCPHW	Homewood Suites by Hilton Rochester-Greece, NY
ROCDTDT	DoubleTree by Hilton Rochester
ROCEMGI	Hilton Garden Inn Rochester-Downtown, NY
ROCFPHX	Hampton Inn & Suites Rochester/Victor, NY
ROCGEHX	Hampton Inn Geneseo, NY
ROCHEHX	Hampton Inn and Suites Rochester/Henrietta, NY
ROCHWHW	Homewood Suites by Hilton Rochester/Henrietta
ROCIRHX	Hampton Inn Rochester/Irondequoit, NY
ROCNYHX	Hampton Inn Rochester North
ROCPTGI	Hilton Garden Inn Rochester/Pittsford, NY
ROCRHHT	Home2 Suites by Hilton Rochester Henrietta, NY
ROCTSDT	DoubleTree by Hilton Strathallen
ROCUAGI	Hilton Garden Inn Rochester/University & Medical Center, NY
ROCVIHW	Homewood Suites Victor, NY
ROCWBHX	Hampton Inn Rochester/Webster, NY
ROGERHX	Hampton Inn and Suites Rogers, MN
ROLLAHX	Hampton Inn Rolla
ROMHIWA	Rome Cavalieri, Waldorf Astoria Hotels & Resorts
ROMRCGI	Hilton Garden Inn Rome Claridge
ROWHSHX	Hampton Inn and Suites Roswell, NM
ROXNCHX	Hampton Inn Roxboro, NC
RPTTXHX	Hampton Inn Rockport/Fulton
RROHIHI	Hilton Sorrento Palace
RSNLAHX	Hampton Inn Ruston
RSTDTDT	DoubleTree by Hilton Rochester-Mayo Clinic Area
RSTMNHX	Hampton Inn Rochester
RSTNOHX	Hampton Inn and Suites Rochester-North, MN
RSTRHGI	Hilton Garden Inn Rochester Downtown
RSTROHW	Homewood Suites Rochester Mayo Clinic Area/ Saint Marys
RSWFMGI	Hilton Garden Inn Fort Myers Airport
RTLHHHX	Hampton Inn Rutland, VT
RTMHITW	Hilton Rotterdam
RUEARHX	Hampton Inn Russellville, AR
RUHAMDI	DoubleTree by Hilton Hotel Riyadh - Al Muroj Business Gate
RUHROGI	Hilton Garden Inn Riyadh Olaya
RVCHMHW	Homewood Suites by Hilton Rockville-Gaithersburg
RVCNYHX	Hampton Inn and Suites Rockville Centre
RWIDTDT	DoubleTree by Hilton Rocky Mount
RWINCHX	Hampton Inn Rocky Mount
RWLWYHX	Hampton Inn Rawlins, WY
RYEHIHH	Hilton Westchester, NY
RZEGIGI	Hilton Garden Inn Rzeszow
RZZCCGI	Hilton Garden Inn Roanoke Rapids, NC
RZZNCHX	Hampton Inn and Suites Roanoke Rapids, NC
SACABHX	Hampton Inn and Suites Sacramento-Cal Expo, CA
SACCAHW	Homewood Suites by Hilton Sacramento Airport-Natomas
SACCODT	Doubletree by Hilton Guest Suites Sacramento-Rancho Cordova
SACEGHX	Hampton Inn and Suites Sacramento/Elk Grove Laguna I-5
SACESES	Embassy Suites by Hilton Sacramento-Riverfront Promenade
SACFOHX	Hampton Inn and Suites Folsom, CA
SACHHHX	Hampton Inn Sacramento/Rancho Cordova
SACHSHX	Hampton Inn and Suites Roseville, CA
SACNNHX	Hampton Inn and Suites Sacramento-North Natomas, CA
SACRVHW	Homewood Suites by Hilton Sacramento/Roseville
SACWLHX	Hampton Inn and Suites Woodland, CA
SAFCRDT	DoubleTree by Hilton Santa Fe
SAFHAHX	Hampton Santa Fe
SALHIHF	Hilton Princess San Salvador
SANAHHF	Hilton San Diego-Airport
SANBEGI	Hilton Garden Inn San Diego/Rancho Bernardo
SANCBHX	Hampton Inn Carlesbad Airport, CA
SANCCHH	Hilton San Diego Bayfront
SANCEDT	DoubleTree by Hilton San Diego/Del Mar
SANCHGI	Hilton Garden Inn Carlsbad Beach
SANCLDT	DoubleTree Club by Hilton San Diego
SANCMDT	DoubleTree by Hilton Golf Resort San Diego
SANCSHX	Hampton Inn San Diego/Mission Valley, CA
SANDEHW	Homewood Suites by Hilton San Diego-Del Mar
SANDLHX	Hampton Inn San Diego/Del Mar
SANDMHF	Hilton San Diego-Del Mar
SANDNES	Embassy Suites by Hilton San Diego Bay-Downtown
SANDTHX	Hampton Inn San Diego Downtown/Airport Area
SANDWDT	DoubleTree by Hilton San Diego Downtown
SANGQHF	Hilton San Diego Gas Lamp Quarter
SANHIHF	Hilton San Diego Resort
SANHWHW	Homewood Suites by Hilton Carlsbad-North San Diego County
SANLJES	Embassy Suites by Hilton San Diego-La Jolla
SANLSHW	Homewood Suites by Hilton San Diego Arprt/Liberty Station
SANMDGI	Hilton Garden Inn San Diego/Del Mar, CA
SANMVHF	Hilton San Diego Mission Valley
SANNOHX	Hampton Inn San Diego/Kearny Mesa
SANPBHX	Hampton Inn and Suites Pittsburg, CA
SANPYHX	Hampton Inn and Suites San Diego/Poway, CA
SANRSHF	Cape Rey Carlsbad, a Hilton Resort
SANSMHX	Hampton Inn San Diego/San Marcos
SANTPHH	Hilton La Jolla Torrey Pines
SAOMOHH	Hilton Sao Paulo Morumbi
SAPHFHF	Hilton Princess San Pedro Sula
SATAHGI	Hilton Garden Inn San Antonio Airport
SATAIHT	Home2 Suites San Antonio Airport
SATAPHF	Hilton San Antonio-Airport
SATBOHX	Hampton Inn and Suites Boerne, TX
SATBRES	Embassy Suites by Hilton San Antonio-N.W. I-10
SATCSHX	Hampton Inn Carrizo Springs, TX
SATDDHX	Hampton Inn and Suites San Antonio/Northeast I-35, TX
SATDNHW	Homewood Suites by Hilton San Antonio-Riverwalk/Downtown
SATDTHX	Hampton Inn San Antonio Downtown/Riverwalk
SATDWDT	DoubleTree by Hilton San Antonio Downtown, TX
SATEMDT	DoubleTree by Hilton The Emily Morgan Hotel
SATESES	Embassy Suites by Hilton San Antonio Rvrwk DT
SATHCHF	Hilton San Antonio Hill Country Hotel & Spa
SATHHHX	Hampton Inn San Antonio/Northwoods
SATHSHX	Hampton Inn & Suites San Antonio Airport, TX
SATHWHW	Homewood Suites by Hilton San Antonio Northwest
SATITHX	Hampton Inn & Suites San Antonio NW/Medical Center
SATJMES	Embassy Suites by Hilton San Antonio Airport
SATKEHX	Hampton Inn Kenedy, TX
SATLOHX	Hampton Inn Selma-San Antonio
SATNOHW	Homewood Suites By Hilton - San Antonio-North, Tx
SATNSDT	DoubleTree by Hilton San Antonio-Airport
SATNWGI	Hilton Garden Inn New Braunfels, TX
SATPDHF	Hilton Palacio del Rio
SATPLHX	Hampton Inn Pleasanton, TX
SATPSHX	Hampton Inn Pearsall, TX
SATRIHT	Home2 Suites San Antonio Downtown-Riverwalk
SATRPGI	Hilton Garden Inn San Antonio @ the Rim
SATSFHX	Hampton Inn & Suites San Antonio-Downtown/Market Sq
SATSGHX	Hampton Inn Seguin, TX
SATSOHW	Homewood Suites San Antonio Southwest/Sea World
SAVAHGI	Hilton Garden Inn Savannah Airport
SAVAIDT	DoubleTree by Hilton Savannah Airport
SAVAPES	Embassy Suites by Hilton Savannah Airport
SAVATHX	Hampton Inn and Suites Savannah-Airport, GA
SAVDHHF	Hilton Savannah Desoto
SAVESES	Embassy Suites by Hilton Savannah
SAVGWHX	Hampton Inn and Suites Savannah I-95 South/Gateway, GA
SAVHSHX	Hampton Inn and Suites Savannah-Historic District, GA
SAVHTDT	DoubleTree by Hilton Historic Savannah
SAVMDHX	Hampton Inn and Suites Savannah-Midtown, GA
SAVMTGI	Hilton Garden Inn Savannah Midtown, GA
SAVNOHX	Hampton Inn Savannah North
SAVRBHW	Homewood Suites by Hilton Savannah Historic Dist./Riverfront
SAVRHHX	Hampton Inn Savannah/Richmond Hill
SAVSHGI	Hilton Garden Inn Savannah Historic District
SAVWBHW	Homewood Suites by Hilton Savannah
SAYREHX	Hampton Inn Sayre, PA
SBAGOHX	Hampton Inn Goleta, CA
SBAMCDT	Fess Parker's DoubleTree by Hilton Resort
SBDMAHX	Hampton Inn Sturbridge
SBGPAHX	Hampton Inn Stroudsburg/Poconos, PA
SBNGSHX	Hampton Inn Goshen, IN
SBNHSHX	Hampton Inn and Suites South Bend
SBNINGI	Hilton Garden Inn South Bend, IN
SBNSBDT	DoubleTree by Hilton South Bend
SBNSQHX	Hampton Inn and Suites Mishawaka, IN
SBPLOHX	Hampton Inn and Suites San Luis Obispo, CA
SBSCOHX	Hampton Inn and Suites Steamboat Springs
SBTDTDT	DoubleTree by Hilton San Bernardino
SBTSAHX	Hampton Inn and Suites San Bernardino CA
SBTSBHW	Homewood Suites by Hilton San Bernardino CA
SBVOHHX	Hampton Inn Steubenville
SBYFLHX	Hampton Inn and Suites Salisbury/Fruitland,MD
SBYMDHX	Hampton Inn Salisbury, MD
SBYOFHF	Hilton Suites Ocean City Oceanfront
SBZHIHI	Hilton Sibiu
SCECLHX	Hampton Inn State College
SCEHSHX	Hampton Inn and Suites State College @ Williamsburg Square
SCESTGI	Hilton Garden Inn State College
SCHNTDT	DoubleTree by Hilton Schenectady
SCHTXHX	Hampton Inn and Suites Schertz, TX
SCKLOHX	Hampton Inn and Suites Lodi, CA
SCKMTHX	Hampton Inn and Suites Manteca, CA
SCKSTHF	Hilton Stockton
SCLGIGI	Hilton Garden Inn Santiago - Airport, Chile
SCLSVDT	DoubleTree by Hilton Santiago
SCOINHX	Hampton Inn and Suites Scottsburg
SCRCCHF	Hilton Scranton & Conference Center
SCRMAHX	Hampton Inn Matamoras/Milford, PA
SCRPAHX	Hampton Inn Clarks Summit
SCTESES	Embassy Suites by Hilton Scottsdale
SCTGIGI	Hilton Garden Inn Scottsdale Old Town
SCTHHHX	Hampton Inn Phoenix Scottsdale @ Shea
SCTHSHX	Hampton Inn and Suites Phoenix/Scottsdale
SCTMVHW	Homewood Suites by Hilton Phoenix/Scottsdale
SCTNPGI	Hilton Garden Inn Scottsdale North/Perimeter Ctr
SCTRWHX	Hampton Inn and Suites Scottsdale/Riverwalk, AZ
SCTSHHF	Hilton Scottsdale
SCVOHHX	Hampton Inn Wheeling/St. Clairsville
SDFAHGI	Hilton Garden Inn Louisville Airport
SDFAPHX	Hampton Inn Louisville Airport
SDFBRHX	Hampton Inn Louisville @ Brooks Road
SDFCVHX	Hampton Inn Louisville North/Clarksville
SDFDNES	Embassy Suites by Hilton Louisville Downtown
SDFDTHX	Hampton Inn Louisville-Downtown, KY
SDFEAHW	Homewood Suites by Hilton Louisville East
SDFEMES	Embassy Suites by Hilton Louisville
SDFHSHX	Hampton Inn and Suites Louisville-East, KY
SDFKYHX	Hampton Inn Louisville-Northeast, KY
SDFLDGI	Hilton Garden Inn Louisville Downtown, KY
SDFLEGI	Hilton Garden Inn Louisville East
SDFNAHX	Hampton Inn New Albany
SDFNEGI	Hilton Garden Inn Louisville/Northeast, KY
SDFSHHF	Hilton Louisville-Seelbach
SDGODT	DoubleTree by Hilton San Diego Mission Valley
SDQSDES	Embassy Suites by Hilton Santo Domingo
SDXSEHH	Hilton Sedona  Resort at Bell Rock
SDYUTHX	Hampton Inn Salt Lake City/Sandy
SEAACDT	DoubleTree by Hilton Arctic Club Hotel Seattle - Downtown
SEAAHHH	Hilton Seattle Airport & Conference Center
SEABLES	Embassy Suites by Hilton Seattle-Bellevue
SEABOGI	Hilton Garden Inn Seattle/Bothell, WA
SEADPHX	Hampton Inn & Suites Dupont, WA
SEADTHX	Hampton Inn and Suites Seattle Downtown
SEAEDHX	Hampton Inn Seattle/Everett Downtown, WA
SEAFWHX	Hampton Inn and Suites Seattle/Federal Way, WA
SEAHMHW	Homewood Suites by Hilton Seattle-Conv Ctr-Pike Street
SEAHWHW	Homewood Suites by Hilton Seattle Downtown
SEAHXHX	Hampton Inn and Suites Tacoma South, WA
SEAIAHX	Hampton Inn & Suites Seattle Airport 28Th Avenue
SEAISGI	Hilton Garden Inn Seattle/Issaquah
SEAKTHX	Hampton Inn and Suites Seattle Kent, WA
SEALWES	Embassy Suites by Hilton Seattle-North-Lynnwood
SEALYHX	Hampton Inn and Suites Seattle North/Lynnwood
SEANNHW	Homewood Suites by Hilton Seattle - Lynnwood, WA
SEANPHX	Hampton Inn and Suites Seattle-Bellevue Downtown, WA
SEARHGI	Hilton Garden Inn Seattle/Renton
SEASHHF	Hilton Seattle
SEASOHX	Hampton Inn Seattle/Southcenter
SEASPDT	DoubleTree Suites by Hilton Seattle
SEATKHW	Homewood Suites Seattle / Tukwila, WA
SEATUES	Embassy Suites by Hilton Seattle-Tacoma International Aprt
SEAUKHT	Home2 Suites Seattle Airport
SEEMAHX	Hampton Inn Seekonk
SELCICI	Conrad Seoul
SELHITW	Millennium Seoul Hilton
SELNCHX	Hampton Inn Selma/Smithfield
SEZDTDI	DoubleTree by Hilton Seychelles - Allamanda Resort & Spa
SEZHIHI	Hilton Seychelles Northolme Resort & Spa
SEZLBHI	Hilton Seychelles Labriz Resort & Spa
SFDDEHX	Hampton Inn Seaford
SFECGHH	Hilton Santa Fe Buffalo Thunder, NM
SFEHIHF	Hilton Santa Fe
SFEHWHW	Homewood Suites by Hilton Santa Fe-North, NM
SFOANGI	Hilton Garden Inn San Francisco Airport North
SFOAODT	DoubleTree by Hilton San Francisco Airport
SFOAPHF	Hilton San Francisco Airport
SFOATHW	Homewood Suites by Hilton San Francisco Airport North, CA
SFOBBGI	Hilton Garden Inn San Francisco/Oakland Bay Bridge
SFOBGES	Embassy Suites by Hilton San Francisco-Airport
SFOCCHX	Hampton San Francisco CC
SFODCHX	Hampton Inn San Francisco/Daly City
SFOEMHW	Homewood Suites Oakland-Waterfront
SFOFDHF	Hilton San Francisco Financial District
SFOFHHH	Hilton San Francisco Union Square
SFOFMHX	Hampton Inn Fremont, CA
SFOHHHX	Hampton San Francisco Airport
SFOHSHX	Hampton San Francisco/Burlingame
SFOHWHX	Hampton Inn San Francisco Bay/Hayward
SFOMPHX	Hampton Inn Milpitas
SFONODT	DoubleTree by Hilton San Francisco Airport North
SFOPHES	Embassy Suites by Hilton Pleasant Hill-Walnut Creek
SFORFES	Embassy Suites by Hilton San Rafael-Conf Center
SFOSFHH	Parc 55 San Francisco A Hilton Hotel
SFOSMGI	Hilton Garden Inn San Mateo
SFOSOES	Embassy Suites by Hilton SFO Airport South
SFQGIGI	Hilton Garden Inn Sanliurfa
SFYLXHX	Hampton Inn and Suites Berkshires/Lenox, MA
SFYMAGI	Hilton Garden Inn Springfield, MA
SGFDTDT	DoubleTree by Hilton Springfield
SGFLBHX	Hampton Inn Lebanon
SGFMOGI	Hilton Garden Inn Springfield
SGHOHHX	Hampton Inn Springfield, OH
SGJBHHX	Hampton Inn St. Augustine Beach
SGJDTHX	Hampton Inn St. Augustine Historic District
SGJFLHX	Hampton Inn St.Augustine
SGJVBHX	Hampton Inn and Suites St. Augustine/Vilano Beach
SGOOHHX	Hampton Inn and Suites Springboro/Dayton Area South, OH
SGUGIGI	Hilton Garden Inn St. George, UT
SGUHHHX	Hampton Inn St. George
SGUZIHX	Hampton Inn and Suites Springdale/Zion National Park, UT
SGVPAHX	Hampton Inn Selinsgrove/Shamokin Dam
SHEWYHX	Hampton Inn Sheridan, WY
SHIVAHX	Hampton Inn South Hill
SHJHITW	Hilton Fujairah Resort
SHJHSHI	Hilton Sharjah
SHMTXHX	Hampton Inn Sherman
SHNOKHX	Hampton Inn Shawnee
SHVBCHX	Hampton Inn Shreveport Bossier City
SHVBSHX	Hampton Inn and Suites Shreveport/Bossier City, LA
SHVHWHW	Homewood Suites Shreveport
SHVLAHX	Hampton Inn Shreveport Airport
SHVMRHW	Homewood Suites Shreveport/Bossier City
SHVOMGI	Hilton Garden Inn Shreveport Bossier City
SHVSHGI	Hilton Garden Inn Shreveport
SHVSOHX	Hampton Inn and Suites Shreveport/South, LA
SHVSPHF	Hilton Shreveport
SIDHHHX	Hampton Inn Sidney
SINCICI	Conrad Centennial Singapore
SINHITW	Hilton Singapore
SJCAPHX	Hampton Inn and Suites San Jose, Costa Rica
SJCCCQQ	Juniper Hotel-Curio Collection By Hilton
SJCCHGI	Hilton Garden Inn Cupertino
SJCCRHX	Hampton Inn Morgan Hill, CA
SJCGHGI	Hilton Garden Inn Gilroy
SJCHSHX	Hampton Inn and Suites San Jose
SJCMHGI	Hilton Garden Inn San Jose/Milpitas
SJCMVGI	Hilton Garden Inn Mountain View
SJCPPDT	DoubleTree by Hilton Campbell
SJCSCHF	Hilton Santa Clara
SJCSHHF	Hilton San Jose
SJCSVHF	Hilton Santa Cruz-Scotts Valley
SJDLCHH	Hilton Los Cabos
SJNCCHH	Condado Lagoon Villas At Caribe Hilton
SJNHIHH	Caribe Hilton
SJODTDT	DoubleTree by Hilton Cariari San Jose
SJOLAGI	Hilton Garden Inn Liberia Airport
SJTCHHX	Hampton Inn San Angelo
SJTWHHT	Home2 Suites by Hilton San Angelo, TX
SJUCOHH	The Condado Plaza Hilton
SJUDTDT	DoubleTree by Hilton San Juan
SJUELHH	El San Juan Hotel & Casino, PR
SJUESES	Embassy Suites by Hilton San Juan Hotel & Casino
SJUGDWA	El Conquistador Resort, PR
SJUHHHX	Hampton Inn San Juan, Puerto Rico
SJULCWA	Las Casitas Resort, Puerto Rico
SKAWAHX	Hampton Inn Spokane
SKYMIHX	Hampton Inn and Suites Sandusky/Milan, OH
SKYOHHX	Hampton Inn Sandusky Central
SLBJAHX	Hampton Inn Salisbury, NC
SLCAPGI	Hilton Garden Inn Salt Lake City Airport, UT
SLCARDT	DoubleTree by Hilton Salt Lake-Airport
SLCCCHH	Hilton Salt Lake City Center
SLCDMWA	Waldorf Astoria Park City, UT
SLCDTHX	Hampton Inn Salt Lake City Downtown
SLCDWGI	Hilton Garden Inn Salt Lake City Downtown, UT
SLCFHHX	Hampton Inn and Suites Salt Lake City-Univ/Foothill Dr, UT
SLCFUHW	Homewood Suites by Hilton Salt Lake City - Midvale/Sandy
SLCHSHX	Hampton Inn and Suites Salt Lake City Airport
SLCHWHW	Homewood Suites by Hilton Salt Lake City Downtown, UT
SLCLAGI	Hilton Garden Inn Salt Lake City/Layton
SLCLNHT	Home2 Suites by Hilton Layton, UT
SLCLYHX	Hampton Inn Salt Lake City-Layton
SLCMUHT	Home2 Suites by Hilton Salt Lake City-Murray, UT
SLCMYHX	Hampton Inn Salt Lake City/Murray
SLCNOHX	Hampton Inn Salt Lake City North
SLCPCHX	Hampton Inn and Suites Park City
SLCRRHX	Hampton Inn Salt Lake City Central
SLCSEGV	Sunrise Lodge, Hilton Grand Vacations
SLCSJHT	Home2 Suites Salt Lake City/South Jordan
SLCSMES	Embassy Suites by Hilton Salt Lake City/West Valley
SLCSYGI	Hilton Garden Inn Salt Lake City/Sandy
SLCTPHT	Home2 Suites by Hilton Lehi/Thanksgiving Point, UT
SLCWJHX	Hampton Inn and Suites West Jordan, UT
SLCWSDT	DoubleTree Suites by Hilton Salt Lake City Downtown
SLCWVHT	Home2 Suites by Hilton Salt Lake City/West Valley City, UT
SLCYWDT	DoubleTree by Hilton Park City - The Yarrow
SLDCOHX	Hampton Inn and Suites Salida, CO
SLENSDT	DoubleTree by Hilton Salem
SLEORHX	Hampton Inn and Suites Salem, OR
SLNKSHX	Hampton Inn Salina
SLOAGHX	Hampton Inn and Suites Arroyo Grande/Pismo Beach Area, CA
SLOCAES	Embassy Suites by Hilton San Luis Obispo
SLOPBGI	Hilton Garden Inn San Luis Obispo/Pismo Beach, CA
SLPHHHH	Hilton San Louis Potosi
SLPLAHX	Hampton Inn Sulphur, LA
SLRTXHX	Hampton Inn Sulphur Springs, TX
SLWHAHX	Hampton Inn Saltillo Airport
SLWHSHX	Hampton Inn and Suites Stillwater
SLWMXDT	DoubleTree Suites by Hilton Saltillo,Mexico
SMAALHX	Hampton Inn Selma
SMEKYHX	Hampton Inn Somerset, KY
SMFEGGI	Hilton Garden Inn Sacramento/Elk Grove, CA
SMFFHGI	Hilton Garden Inn Folsom
SMFHIHF	Hilton Sacramento-Arden West
SMFRHGI	Hilton Garden Inn Roseville
SMFSNGI	Hilton Garden Inn Sacramento-South/Natomas, CA
SMFWEHX	Hampton Inn and Suites West Sacramento, CA
SMLSCHX	Hampton Inn Summerville
SMOPCDT	DoubleTree Suites by Hilton Santa Monica
SNAAHHH	Hilton Anaheim
SNAAOES	Embassy Suites by Hilton Anaheim/Orange
SNACAGI	Hilton Garden Inn Fontana, CA
SNACCDT	DoubleTree by Hilton Anaheim/Orange County
SNACMHH	Hilton Orange County/Costa Mesa
SNADCDT	DoubleTree Suites by Hilton Anaheim Resort-Convention Center
SNAFMDT	DoubleTree Club by Hilton Orange County Airport
SNAGGGI	Hilton Garden Inn Anaheim/Garden Grove
SNAIJGI	Hilton Garden Inn Irvine/ Orange County Airport
SNAIRGI	Hilton Garden Inn Irvine East/Lake Forest
SNAOCHF	Hilton Irvine-Orange County-Airport
SNAPEDT	DoubleTree Suites by Hilton Doheny Beach
SNCCAES	Embassy Suites by Hilton Santa Clara-Silicon Valley
SNFNCHX	Hampton Inn Sanford
SNMESES	Embassy Suites by Hilton San Marcos-Hotel,Spa & Conf Ctr
SNMTXHX	Hampton Inn and Suites San Marcos
SNPNCHX	Hampton Inn and Suites Southern Pines/Pinehurst, NC
SNSCAHX	Hampton Inn and Suites Salinas, CA
SNTSCHX	Hampton Inn Santee
SNWNBHI	Hilton Ngapali Resort & Spa
SNYNEHX	Hampton Inn Sidney, NE
SOMPAHX	Hampton Inn Somerset, PA
SOPNCHW	Homewood Suites by Hilton Olmsted Village-Pinehurst, NC
SOUAGHI	Hilton at the Ageas Bowl, Southampton
SOUHNHN	Hilton Southampton
SOWAZHX	Hampton Inn and Suites Show Low/Pine Top, AZ
SPAHSHX	Hampton Spartanburg-I-26-Westgate Mall
SPASCHX	Hampton Inn Spartanburg North
SPCCDT	DoubleTree by Hilton Spokane-City Center
SPFRDHX	Hampton Inn West Springfield
SPFTSHX	Hampton Inn Spearfish, SD
SPGTNHX	Hampton Inn Springfield, TN
SPHFLHX	Hampton Inn Spring Hill
SPIASDT	The President Abraham Lincoln Springfield, A DT by Hilton
SPIDKHX	Hampton Inn Springfield, IL
SPIGIGI	Hilton Garden Inn Springfield, IL
SPIILHX	Hampton Inn and Suites Springfield Southwest
SPILNHX	Hampton Inn Lincoln, IL
SPLNJHX	Hampton Inn South Plainfield, NJ
SPLSOHI	Hilton Royal Parc Soestduinen
SPRSHHF	Hilton Springfield, VA
SPSHWHW	Homewood Suites by Hilton Wichita Falls, TX
SPSSSHX	Hampton Inn Wichita Falls-Sikes Senter Mall, TX
SPSVEHX	Hampton Inn Vernon, TX
SPTNCHX	Hampton Inn Southport
SPTSHHF	Hilton St. Petersburg
SRQATHX	Hampton Inn and Suites Sarasota-Airport, FL
SRQDTHX	Hampton Inn Bradenton Downtown Historic District, FL
SRQELHX	Hampton Inn Ellenton
SRQFLHX	Hampton Inn Sarasota/Bee Ridge
SRQHWHW	Homewood Suites by Hilton Sarasota, FL
SRQNBGI	Hilton Garden Inn Sarasota Bradenton Airport
SRQUPHX	Hampton Inn and Suites Sarasota/Lakewood Ranch, FL
SRZEQHX	Hampton Inn Santa Cruz/Equipetrol, Bolivia
SSHDRHI	Hilton Sharm Dreams Resort
SSHSBHI	Hilton Sharks Bay Resort
SSHWFHI	Hilton Sharm Waterfalls Resort
STAESES	Embassy Suites by Hilton Santa Ana-Orange Cty Apt North
STAHSHX	Hampton Inn and Suites Santa Anna/Orange Count Airport
STAOCDT	DoubleTree by Hilton Santa Ana-Orange County Airport
STBOHHX	Hampton Inn and Suites Cleveland Southeast/Streetsboro
STCLDHX	Hampton Inn and Suites St. Cloud, MN
STCMNHW	Homewood Suites by Hilton St. Cloud, MN
STFMSHX	Hampton Inn Starkville
STFSVGI	Hilton Garden Inn Starkville
STJHIHH	Hilton Saint John
STJMOHX	Hampton Inn St. Joseph, MO
STLAPHX	Hampton Inn St. Louis Airport, MO
STLBHHX	Hampton Inn and Suites St. Louis South-I-55, MO
STLBVHF	Hilton St. Louis at the Ballpark
STLCDHW	Homewood Suites by Hilton Chesterfield
STLCFHX	Hampton Inn St. Louis/Chesterfield
STLCHGI	Hilton Garden Inn St.Louis/Chesterfield
STLCLHX	Hampton Inn St. Louis/Columbia, IL
STLCNDT	DoubleTree by Hilton St Louis/Collinsville
STLCVHX	Hampton Inn St. Louis/Collinsville
STLDDHF	Hilton St. Louis Downtown
STLDSHX	Hampton Inn St. Louis/Westport
STLDTHX	Hampton Inn St. Louis-Downtown (At the Gateway Arch), MO
STLEAGI	Hilton Garden Inn Shiloh/OFallon
STLEDHX	Hampton Inn and Suites St. Louis/Edwardsville, IL
STLEMES	Embassy Suites by Hilton St. Louis / St. Charles
STLESES	Embassy Suites by Hilton St. Louis-Airport
STLFHHF	Hilton St. Louis-Frontenac
STLFVHX	Hampton Inn St. Louis/Fairview Heights
STLGAHX	Hampton Inn and Suites Clayton/St. Louis-Galleria Area, MO
STLHIHF	Hilton St. Louis-Airport
STLHLHX	Hampton Inn and Suites St. Louis/Highlands, MO
STLHSHX	Hampton Inn and Suites St. Louis/Chesterfield
STLHWHW	Homewood Suites by Hilton St. Louis/Galleria, MO
STLNPGI	HILTON GARDEN INN ST. LOUIS AIRPORT
STLOFGI	HILTON GARDEN INN ST. LOUIS/OFALLON
STLPPHX	Hampton Inn St. Louis 1-44 Southwest
STLRVHW	Homewood Suites by Hilton St. Louis Riverport - Airport West
STLSCDT	DoubleTree by Hilton St. Louis
STLSHHX	Hampton Inn St. Louis/Sunset Hills
STLSTHX	Hampton Inn St. Louis/St. Charles
STLUSDT	DoubleTree by Hilton St. Louis Union Station
STLWAES	Embassy Suites by Hilton St. Louis, MO
STLWPDT	DoubleTree by Hilton St. Louis at Westport
STNAPHN	Hilton London Stansted Airport
STNCBDI	DoubleTree by Hilton Cambridge City Centre
STNHCHI	Hilton Cambridge, United Kingdom
STOOHHX	Hampton Inn Stow, OH
STOSLHI	Hilton Stockholm Slussen
STRMOHX	Hampton Inn St. Robert/Ft. Leonard Wood
STRPKGI	Hilton Garden Inn Stuttgart Neckarpark
STSAPGI	Hilton Garden Inn Sonoma County Airport, CA
STSRPHX	Hampton Inn and Suites Rohnert Park, CA
STSSCHF	Hilton Sonoma County-Santa Rosa
STSWIHX	Hampton Inn and Suites Windsor/Sonoma Wine Country
STVPTHX	Hampton Inn Plover/Stevens Point, WI
SUANOHX	Hampton Inn and Suites Stuart-North, FL
SUMMNHX	Hampton Inn Manning, SC
SUMSCHX	Hampton Inn Sumter
SUXGIGI	Hilton Garden Inn Sioux City Riverfront, IA
SVHHHHX	Hampton Inn Statesville, NC
SVLWVHX	Hampton Inn Summersville
SVNMIHX	Hampton Inn South Haven
SVOHFHI	Hilton Moscow Leningradskaya
SVQGIGI	Hilton Garden Inn Sevilla
SVRTNHX	Hampton Inn Sevierville
SVXCCDI	DoubleTree by Hilton Ekaterinburg City Centre
SWFFKGI	Hilton Garden Inn Poughkeepsie/Fishkill
SWFNWHW	Homewood Suites by Hilton Newburgh-Stewart Airport
SWIHNHN	Hilton Swindon
SWYPAHX	Hampton Inn Shrewsbury
SXBHITW	Hilton Strasbourg
SYCVAHX	Hampton Inn Stony Creek/Petersburg Area, VA
SYDHITW	Hilton Sydney
SYRAPHX	Hampton Inn Syracuse North
SYRAUGI	Hilton Garden Inn Auburn, NY
SYRCYHX	Hampton Inn SYRACUSE/CLAY, NY
SYRDTDT	DoubleTree by Hilton Syracuse
SYRDWES	Embassy Suites by Hilton Syracuse
SYRERHX	Hampton Inn and Suites Syracuse Erie Boulevard, NY
SYRHWHW	Homewood Suites by Hilton Syracuse/Liverpool
SYRSHGI	Hilton Garden Inn Syracuse
SZDCRDI	DoubleTree by Hilton Sheffield Park
SZDSHHN	Hilton Sheffield
SZFHXHX	Hampton Inn Samsun
SZZSWHX	Hampton Inn Swinoujscie
TAMHSHX	Hampton Inn Tampico, Tamaulipas, Mexico
TAONMHX	Hampton Inn Taos
TBAHITW	Hilton Taba Resort & Nelson Village
TBRBAHX	Hampton Inn Statesboro, GA
TCCSRHX	Hampton Inn Santa Rosa, NM
TCLALHX	Hampton Inn Tuscaloosa University
TCLBMHX	Hampton Inn Tuscaloosa I-59
TCLRTES	Embassy Suites by Hilton Tuscaloosa Downtown
TCMPYHX	Hampton Inn and Suites Tacoma/Puyallup, WA
TEQCOGI	Hilton Garden Inn Corlu, Turkey
TERHIDT	DoubleTree by Hilton Tarrytown
TFTGIGI	Hilton Garden Inn Tifton, GA
TFTSOHX	Hampton Inn and Suites Tifton, GA
TGZGIGI	Hilton Garden Inn Tuxtla
THLAPDT	DoubleTree by Hilton Tallahassee
THMTNHX	Hampton Inn Tullahoma
TIXFLHX	Hampton Inn Titusville I-95/Kennedy Spc Ctr.
TJMOSDI	DoubleTree by Hilton Tyumen, Russia
TKATXHX	Hampton Inn and Suites Texarkana, TX
TLAREHX	Hampton Inn and Suites Tulare, CA
TLHEHGI	Hilton Garden Inn Tallahassee Central
TLHHHHX	Hampton Inn Tallahassee Central
TLHHSHX	Hampton Inn and Suites Tallahassee I-10/Thomasville Road, FL
TLHHWHW	Homewood Suites by Hilton Tallahassee
TLHTLGI	Hilton Garden Inn Tallahassee
TLLHIHI	Hilton Tallinn Park
TLVHITW	Hilton Tel Aviv
TOIALHX	Hampton Inn Troy
TOLHSHX	Hampton Inn and Suites Toledo North
TOLMEHW	Homewood Suites by Hilton Toledo/Maumee
TOLPBGI	Hilton Garden Inn Toledo/Perrysburg, OH
TOLPGHX	Hampton Inn and Suites Toledo/Perrysburg, OH
TOLSOHX	Hampton Inn Toledo South/Maumee
TOLWGHX	Hampton Inn and Suites Toledo/Westgate, OH
TOPKSHX	Hampton Inn Topeka, KS
TORHIHH	Hilton Toronto
TPAAHHF	Hilton Tampa-Airport-Westshore
TPAAPHW	Homewood Suites by Hilton Tampa Airport - Westshore
TPAATHX	Hampton Inn Tampa Airport/Westshore
TPABDES	Embassy Suites by Hilton Tampa-Brandon
TPABRHX	Hampton Inn Tampa/Brandon
TPAEBGI	Hilton Garden Inn Tampa East  Brandon
TPAESES	Embassy Suites by Hilton Tampa-Downtown Convention Center
TPAFLES	Embassy Suites by Hilton Tampa-Airport-Westshore
TPAFMGI	Hilton Garden Inn Ft. Myers
TPAFRES	Embassy Suites by Hilton Tampa-USF-Near Busch Gardens
TPAHSHX	Hampton Inn and Suites Tampa East (Casino Area), FL
TPAHWHW	Homewood Suites by Hilton Tampa/Brandon, FL
TPANHGI	Hilton Garden Inn Tampa North
TPANOHX	Hampton Inn and Suites Tampa North
TPANTHF	Hilton Tampa Downtown, FL
TPANWGI	Hilton Garden Inn Tampa Northwest/Oldsmar
TPAOMHX	Hampton Inn and Suites Tampa Northwest/Oldsmar, FL
TPARHDT	DoubleTree Suites by Hilton Tampa Bay
TPARPHX	Hampton Inn Tampa-Airport/Rocky Point, FL
TPASEGI	Hilton Garden Inn Tampa/Riverview/Brandon, FL
TPATLDT	DoubleTree by Hilton Tampa-Westshore Airport
TPATSHX	Hampton Inn and Suites Tarpon Springs
TPAVEHX	Hampton Inn Tampa-Veterans Expwy/Waters Ave
TPAWCHX	Hampton Inn and Suites Tampa/Wesley Chapel, FL
TPAWSGI	Hilton Garden Inn Tampa Airport/Westshore, FL
TPAYBHX	Hampton Inn and Suites Tampa-Ybor City/Downtown
TPAYCGI	Hilton Garden Inn Tampa Ybor Historic District
TPLGIGI	Hilton Garden Inn Temple, TX
TPLSGHX	Hampton Inn Temple, TX
TRACYHX	Hampton Inn Tracy
TRCHAHX	Hampton Inn Torreon
TRCHWHW	Homewood Suites by Hilton Torreon, Coahuila, Mexico
TREUTHX	Hampton Inn Tremonton, UT
TRIDTDT	DoubleTree by Hilton Johnson City
TRIJCHX	Hampton Inn Johnson City
TRVGIGI	Hilton Garden Inn Trivandrum
TRVNJHX	Hampton Inn Turnersville (Philadelphia Area), NJ
TRYOHHX	Hampton Inn Troy, OH
TSEAKGI	Hilton Garden Inn Astana
TTNHAHW	Homewood Suites by Hilton Hamilton, NJ
TTNHLGI	Hilton Garden Inn Hamilton, NJ
TTNHRHX	Hampton Inn and Suites Robbinsville, NJ
TTNMHGI	Hilton Garden Inn Mount Holly/Westampton, NJ
TUCAPGI	Hilton Garden Inn Tucson Airport, AZ
TUCGIGI	Hilton Garden Inn Tucuman, Argentina
TULAHGI	Hilton Garden Inn Tulsa Airport
TULBAHX	Hampton Inn Tulsa/Broken Arrow
TULBYHX	Hampton Inn and Suites Tulsa South/Bixby, OK
TULCEHX	Hampton Inn and Suites Tulsa Central, OK
TULCTHX	Hampton Inn and Suites Tulsa-Catoosa, OK
TULESES	Embassy Suites by Hilton Tulsa-I-44
TULHSHX	Hampton Inn and Suites Tulsa/Woodland Hills
TULHWHW	Homewood Suites by Hilton Tulsa-South, OK
TULMDGI	Hilton Garden Inn Tulsa Midtown, OK
TULOWHX	Hampton Inn and Suites Tulsa North/Owasso, OK
TULSDDT	DoubleTree by Hilton Tulsa-Downtown
TULSGGI	Hilton Garden Inn Tulsa South
TULSOHX	Hampton Inn and SuitesTulsa/Tulsa Hills, OK
TULSYDT	DoubleTree by Hilton Tulsa at Warren Place
TUPBCHX	Hampton Inn and Suites Tupelo/Barnes Crossing, MS
TUPNAHX	Hampton Inn New Albany, MS
TUPTUGI	Hilton Garden Inn Tupelo, MS
TUPWPHX	Hampton Inn and Suites West Point, MS
TUSBTDT	DoubleTree by Hilton Tucson-At Reid Park
TUSEAHX	Hampton Inn & Suites Tucson East/Williams Center, Az+++
TUSESES	Embassy Suites by Hilton Tucson Paloma Village
TUSGRHX	Hampton Inn Tucson North
TUSHEHF	Hilton Tucson East
TUSHSHX	Hampton Inn and Suites Tucson-Mall
TUSHTHH	Hilton Tucson El Conquistador Golf and Tennis Resort
TUSSPHW	Homewood Suites by Hilton Tucson/St. Philip's Plaza Univ
TUSSSHX	Hampton Inn Tulsa/Sand Springs
TUSTADT	DoubleTree by Hilton Tucson Airport
TUSTBHX	Hampton Tucson Airport
TUSTWDT	DoubleTree by Hilton Suites Tuucson-Williams Center, AZ
TUUGIGI	Hilton Garden Inn Tabuk
TVCLMHX	Hampton Inn Traverse City
TVLGAHX	Hampton Inn Thomasville
TWFIDHX	Hampton Inn Twin Falls
TWFTFGI	Hilton Garden Inn Twin Falls, ID
TXKCRHX	Hampton Inn Texarkana, AR
TXKHPHX	Hampton Inn and Suites Hope, AR
TXKTXGI	Hilton Garden Inn Texarkana
TXLBCHX	Hampton Inn Berlin City West
TYOCICI	Conrad Tokyo
TYOHITW	Hilton Tokyo
TYOODHI	Hilton Odawara Resort & Spa
TYOTBTW	Hilton Tokyo Bay
TYOTOHI	Hilton Tokyo Odaiba
TYRLDHX	Hampton Inn Lindale/Tyler
TYRTXHX	Hampton Inn Tyler
TYRTYGI	Hilton Garden Inn Tyler, TX
TYSAPHX	Hampton Inn Knoxville Airport
TYSCLHX	Hampton Inn Knoxville/Clinton I-75, TN
TYSDDHX	Hampton Inn Dandridge, TN
TYSEAHX	Hampton Inn Knoxville-East, TN
TYSHWHW	Homewood Suites Knoxville
TYSKHGI	Hilton Garden Inn Knoxville West/Cedar Bluff, TN
TYSKNGI	Hilton Garden Inn Knoxville/University, TN
TYSKWES	Embassy Suites by Hilton Knoxville West
TYSNOHX	Hampton Inn and Suites Knoxville/North I-75, TN
TYSSVHX	Hampton Inn and Suites Sevierville at Stadium Drive, TN
TYSTCHX	Hampton Inn and Suites Knoxville-Turkey Creek/Farragut, TN
TYSWSHX	Hampton Inn Knoxville-West At Cedar Bluff, TN
TZXGIGI	Hilton Garden Inn Trabzon
UCANHHX	Hampton Inn & Suites New Hartford
UCANYHX	Hampton Inn Utica, NY
UFAGIGI	Hilton Garden Inn Ufa Riverside
UFAHXHX	Hampton Inn Ufa
UINILHX	Hampton Inn Quincy, IL
UKHCAHX	Hampton Inn Ukiah
ULYGSGI	Hilton Garden Inn Ulyanovsk
UNTPAHX	Hampton Inn Uniontown
USMKRCI	Conrad Koh Samui Residences
USMKSCI	Conrad Koh Samui
USTHDHF	Hilton St. Augustine - Historic Bayfront
USTSMDT	DoubleTree by Hilton St. Augustine Historic District
USTSTGI	Hilton Garden Inn St. Augustine Beach
VACCAHX	Hampton Inn and Suites Vacaville/Napa Valley
VALESES	Embassy Suites by Hilton Valencia
VALINHX	Hampton Inn and Suites Valparaiso
VALVHGI	Hilton Garden Inn Valencia Six Flags
VANDIDI	Doubletree by Hilton Van, Turkey
VANVWDT	DoubleTree by Hilton Vancouver
VANWAHW	Homewood Suites by Hilton Portland-Vancouver
VARGSDI	DoubleTree by Hilton Varna - Golden Sands
VCEGIGI	Hilton Garden Inn Venice Mestre
VCEHIHI	Hilton Molino Stucky Venice
VCEMVDI	DoubleTree by Hilton Venice - North
VCTHSGI	Hilton Garden Inn Victoria, TX
VCTJSHW	Homewood Suites by Hilton Victoria, TX
VCTTXHX	Hampton Inn Victoria, TX
VCVGIGI	Hilton Garden Inn Victorville, CA
VDIGAHX	Hampton Inn Vidalia, GA
VENFLHX	Hampton Inn and Suites Venice/South Sarasota
VERBRGI	Hilton Garden Inn Boca del Rio, Veracruz, MX
VHNFRHX	Hampton Inn Van Horn, TX
VIEGIGI	Hotel Vienna South, a Hilton Garden Inn affiliate Hotel
VIEHAHI	Hilton Vienna Danube Waterfront, Austria
VIEHITW	Hilton Vienna, Austria
VIEPWTW	Hilton Vienna Plaza, Austria
VISCAHX	Hampton Inn Visalia, CA
VKSBGHX	Hampton Inn and Suites Vicksburg, MS
VLDCCHX	Hampton Inn and Suites Valdosta Conference Center
VLDGAGI	Hilton Garden Inn Valdosta, GA
VLDLPHX	Hampton Inn Valdosta/Lake Park
VOGVPHX	Hampton By Hilton Volgograd Profsoyuznaya
VORHEHX	Hampton Inn Philadelphia/Voorhees, NJ
VORNJHX	Hampton Inn Cherry Hill/Voorhees
VOZHXHX	Hampton Inn Voronezh, Russia
VSAAHHH	Hilton Villahermosa & Conference Center
VYSILHX	Hampton Inn and Suites Peru, IL
WALCTHW	Homewood Suites by Hilton Wallingford-Meriden
WARHNHN	Hilton Warwick / Stratford-upon-Avon
WARSWHX	Hampton Inn Warsaw, IN
WASALHX	Hampton Inn Alexandria Old Town King Street
WASAXHX	Hampton Inn & Suites Alexandria-Old Town Area South
WASBHDT	DoubleTree by Hilton Bethesda
WASBTGI	Hilton Garden Inn Bethesda
WASCCES	Embassy Suites by Hilton Washington DC Convention Center
WASCHES	Embassy Suites by Hilton Chevy Chase Pavilion
WASCLHX	Hampton Inn College Park
WASCNHX	Hampton Inn Washington Dulles Airport South
WASCRES	Embassy Suites by Hilton Crystal City-National Airport
WASDAES	Embassy Suites by Hilton Dulles Airport
WASDFHX	Hampton Inn Dumfries/Quantico
WASDLHW	Homewood Suites by Hilton Washington Dulles Airport
WASDNES	Embassy Suites by Hilton Washington DC Georgetown
WASDTDT	DoubleTree by Hilton Washington D.C.
WASDUHX	Hampton Inn and Suites Washington/Dulles Interntnl Airport
WASFBHX	Hampton Inn and Suites Alexandria/Ft. Belvoir, VA
WASGVHX	Hampton Inn Gainsville/Haymarket, VA
WASHHHX	Hampton Washington-Downtown-Convention Center, DC
WASHNHX	Hampton Inn and Suites Herndon/Reston, VA
WASHSHX	Hampton Inn Washington, DC/White House
WASHWHW	Homewood Suites by Hilton Washington, D.C. Downtown
WASLBHX	Hampton Inn and Suites Leesburg
WASLDHW	Homewood Suites by Hilton Dulles-North/Loudoun, VA
WASLGHW	Homewood Suites by Hilton Leesburg, VA
WASLLHX	Hampton Inn Laurel(Fort Meade Area), MD
WASMFHW	Homewood Suites by Hilton Falls Church
WASNLES	Embassy Suites by Hilton Dulles - North Loudoun
WASNYHX	Hampton Inn & Suites Washington, D.C./Navy Yard Area
WASOTES	Embassy Suites by Hilton Alexandria-Old Town
WASOXHX	Hampton Inn and Suites National Harbor, MD
WASRRHX	Hampton Inn and Suites Crystal City
WASSLHX	Hampton Inn Dulles/Cascades
WASSSHX	Hampton Silver Spring
WASSVHW	Homewood Suites Silver Spring
WASTSES	Embassy Suites by Hilton Tysons Corner
WASWBHX	Hampton Inn Potomac Mills/Woodbridge, VA
WASWEGI	Hilton Garden Inn Washington Dc/ Georgetown Area
WASWLHX	Hampton Inn Waldorf
WATHNHN	Hilton Watford, United Kingdom
WAWAPHX	Hampton by Hilton Warsaw Airport
WAWCCDI	DoubleTree by Hilton Hotel & Conference Centre Warsaw,Poland
WAWCTHX	Hampton By Hilton  Warsaw City
WAWHIHI	Hilton Warsaw Hotel & Convention Centre
WAYPAHX	Hampton Inn Waynesburg, PA
WBDHAHX	Hampton Inn Woodbridge, NJ
WBGCLHX	Hampton Inn and Suites Williamsburg-Central, VA
WBGHWHW	Homewood Suites by Hilton Williamsburg
WBGKRDT	DoubleTree by Hilton Williamsburg
WBGRRHX	Hampton Inn and Suites Williamsburg Richmond Road
WBGVAES	Embassy Suites by Hilton Williamsburg
WBUCOHX	Hampton Inn Denver Northeast-Brighton, CO
WBUGBHX	Hampton Inn and Suites Boulder-North
WCHOHHX	Hampton Inn Washington Court House
WCVCAHX	Hampton Inn Los Angeles/West Covina
WDGOKHX	Hampton Inn and Suites Enid, OK
WDHHIHI	Hilton Windhoek
WELFLHX	Hampton Inn and Suites Wellington, FL
WELMEHX	Hampton Inn and Suites Wells/Ogunquit, ME
WFDTXHX	Hampton Inn Weatherford, TX
WGVPAHX	Hampton Inn Philadelphia/Willow Grove
WHEWVHX	Hampton Inn Wheeling
WHTNCHX	Hampton Inn Washington, NC
WHVFLHX	Hampton Inn Winter Haven
WILNCHX	Hampton Inn Williamston
WINNJHX	Hampton Inn East Windsor, NJ
WINWVHX	Hampton Inn Winfield/Teays Valley
WKBNCHX	Hampton Inn Wilkesboro
WLNHSHX	Hampton Inn and Suites Wilson I-95
WLTSCHX	Hampton Inn Walterboro
WMHARHX	Hampton Inn Mountain Home, AR
WNCCHGI	Hilton Garden Inn Winchester, VA
WNCHHHX	Hampton Inn Winchester North
WNCVAHX	Hampton Inn Winchester University Mall
WNDAPHX	Hampton Inn Hartford Airport
WNDHWHW	Homewood Suites by Hilton Hartford Downtown
WNDLKHW	Homewood Suites by Hilton Hartford/Windsor Locks
WODHIHF	Hilton Woodcliff Lake
WOOOHHX	Hampton Inn Wooster
WPTPAHX	Hampton Inn Williamsport-Downtown, PA
WRBGAHX	Hampton Inn Warner Robins
WRJVTHX	Hampton Inn White River Junction
WRWHSHX	Hampton Inn & Suites Providence/Warwick Airport,RI
WRWHWHW	Homewood Suites by Hilton Providence-Warwick
WSGPAHX	Hampton Inn Washington, PA
WTHVNHX	Hampton Inn and Suites New Haven-South/West Haven, CT
WTVMEHX	Hampton Inn Waterville
WTYCTHX	Hampton Inn Waterbury, CT
WWROKHX	Hampton Inn and Suites Woodward, OK
WYBSDHX	Hampton Inn Waynesboro
WYTVAHX	Hampton Inn Wytheville
XEBHIHI	Hilton Evian-les-Bains
XKUKUDI	DoubleTree by Hilton Kusadasi
XLVNFHF	Hilton Niagara Falls
XLVNLGI	Hilton Garden Inn Niagara on the Lake
XNAESES	Embassy Suites by Hilton Northwest Arkansas
XNAJPGI	Hilton Garden Inn Joplin, MO
XOKCNHX	Hampton Inn Oakville/Mississiauga
XWOWODI	Doubletree by Hilton Woking, United Kingdom
YCWLRHX	Hampton Inn Chilliwack, British Columbia, Canada
YEGFSHX	Hampton Inn Fort Saskatchewan, Alberta, Canada
YEGGIGI	Hilton Garden Inn Edmonton International Airport
YEGHSHX	Hampton Inn and Suites Edmonton Intl Airport Alberta, CA
YEGNMDT	DoubleTree by Hilton West Edmonton
YEGOMHT	Home2 West Edmonton
YEGSOHX	Hampton Inn South Edmonton/South, Alberta, Canada
YEGWEGI	Hilton Garden Inn West Edmonton
YEGWTHX	Hampton Inn and Suites West Edmonton, Alberta, Canada
YHMCNHX	Hampton Inn and Suites by Hilton Brantford
YHMHWHW	Homewood Suites by Hilton Hamilton, Ontario, Canada
YHMSJHW	Homewood Suites by Hilton Waterloo/St. Jacobs
YHZDTHX	Hampton Inn and Suites Dartmouth, Nova Scotia, Canada
YHZDWHW	Homewood  Suites Halifax Downtown
YHZDXHX	Hampton Inn Halifax Downtown
YHZHGGI	Hilton Garden Inn Halifax Airport, Nova Scotia
YHZHHDT	The Hollis Halifax - a DoubleTree Suites by Hilton
YKFCNHX	Hampton Inn and Suites Kitchener, Ontario, Canada
YKMELHX	Hampton Inn Ellensburg, WA
YKMYAGI	Hilton Garden Inn Yakima, WA
YLLYDHX	Hampton Inn Lloydminster, Alberta, Canada
YNGATHX	Hampton Inn Youngstown West
YNGCFHX	Hampton Inn and Suites Youngstown/Canfield, OH
YNGNCHX	Hampton Inn and Suites New Castle, PA
YNGNOHX	Hampton Inn Youngstown North
YNGOHHX	Hampton Inn Youngstown/Boardman
YNGSHHX	Hampton Inn and Suites Sharon, PA
YNJBCHX	Hampton Inn and Suites Langley/Surrey, BC, Canada
YORNEHX	Hampton Inn York, NE
YOWAPGI	Hilton Garden Inn Ottawa Airport
YOWARDT	DoubleTree by Hilton Gatineau-Ottawa
YOWCNHX	Hampton Inn Ottawa
YOWOVHF	Hilton Lac Leamy
YQBHIHH	Hilton Quebec
YQBMTHW	Homewood Suites by Hilton Mont-Tremblant Resort
YQFRDHX	Hampton Inn and Suites Red Deer, Alberta, Canada
YQGCNHX	Hampton Inn and Suites Windsor
YQLLEHX	Hampton Inn and Suites Lethbridge, Alberta, Canada
YQMNBHX	Hampton Inn and Suites Moncton, New Brunswick, Canada
YQRCCDT	DoubleTree by Hilton Regina
YQRGAHX	Hampton Inn and Suites Regina East Gate, SK
YQYNSHX	Hampton Inn Sydney, Nova Scotia, CA
YRKHWHW	Homewood Suites by Hilton York, PA
YRKPAHX	Hampton Inn York, PA
YSBHWHW	Homewood Suites by Hilton Sudbury, Ontario, Canada
YSBRYHX	Hampton Inn Sudbury, Ontario, Canada
YSJSJHX	Hampton Inn and Suites Saint John, New Brunswick, Canada
YTOAJHW	Homewood Suites by Hilton Ajax, Ontario, Canada
YTOBMHX	Hampton Inn Toronto/Brampton, Ontario, Canada
YTOBRGI	Hilton Garden Inn Toronto/Brampton, ON
YTOCSDT	DoubleTree by Hilton Toronto Downtown
YTOHWHW	Homewood Suites by Hilton Toronto-Mississauga
YTOMIHW	Homewood Suites by Hilton Toronto Airport Corporate Centre
YTOMSHX	Hampton Inn Toronto/Mississauga
YTOSOHX	Hampton Inn Toronto Airport Corp Center Ontario, Canada
YTOTVGI	Hilton Garden Inn Toronto/Oakville
YUBCAHX	Hampton Inn and Suites Yuba City, CA
YULCVGI	Hilton Garden Inn Montreal Centre-Ville
YULDNES	Embassy Suites by Hilton Montreal
YULDVHX	Hampton Inn and Suites Montreal
YULHLHF	Hilton Montreal/Laval
YULLVHX	Hampton Inn and Suites Laval, Quebec, Canada
YUMAZHX	Hampton Inn and Suites Yuma, AZ
YUMHWHW	Homewood Suites by Hilton Yuma, AZ
YUMRSGI	Hilton Garden Inn Yuma Pivot Point
YVRAHHF	Hilton Vancouver Airport
YVRHSHX	Hampton Inn and Suites Vancouver-Downtown, BC, Canada
YVRRHHX	Hampton Inn Vancouver-Airport/Richmond,BC, Canada
YVRVMHF	Hilton Vancouver Metrotown
YWGAPHX	Hampton Inn Winnipeg Airport - Polo Park
YWGWIHF	Hilton Suites Winnipeg Airport
YWGWWHW	Homewood Suites by Hilton Winnipeg Airport-Polo Park
YWSVRHF	Hilton Whistler Resort & Spa
YXESDGI	Hilton Garden Inn Saskatoon Downtown, SK, Canada
YXESSHX	Hampton Inn Saskatoon South, SK, Canada
YXUHWHW	Homewood Suites by Hilton London, Ontario
YXULDHX	Hampton Inn London, Ontario, CA
YYBNBHX	Hampton Inn North Bay, ON, Canada
YYCAHGI	Hilton Garden Inn Calgary Airport
YYCAIHX	Hampton Inn and Suites Airdrie, Alberta, Canada
YYCAPHX	Hampton Inn Calgary-Airport North
YYCHSHX	Hampton Inn and Suites Calgary Northwest
YYCHWHW	Homewood Suites by Hilton Calgary-Airport+++
YYJDSDT	DoubleTree by Hilton Victoria
YYTAPHX	Hampton Inn and Suites St. John's Airport, NL, Canada
YYZAJGI	Hilton Garden Inn Toronto/Ajax, Ontario, Canada
YYZAPHF	Hilton Suites Toronto/Markham-Conference Centre, CA
YYZBUGI	Hilton Garden Inn Toronto/Burlington, Ontario
YYZCBHW	Homewood Suites by Hilton Cambridge-Waterloo, Ontario
YYZCMGI	Hilton Garden Inn Kitchener/Cambridge
YYZDTGI	Hilton Garden Inn Toronto Downtown
YYZHIHH	Hilton Toronto Airport Hotel & Suites
YYZHSHX	Hampton Inn and Suites Toronto Airport
YYZHWHW	Homewood Suites by Hilton Toronto-Markham
YYZMAGI	Hilton Garden Inn Toronto/Markham
YYZMKHX	Hampton Inn and Suites Markham, Ontario, Canada
YYZMOHH	Hilton Mississauga Meadowvale
YYZMSGI	Hilton Garden Inn TORONTO/MISSISSAUGA
YYZMTGI	Hilton Garden Inn Toronto Airport West/Mississauga, Ontario
YYZOVHW	Homewood Suites by Hilton Toronto-Oakville
YYZTAGI	Hilton Garden Inn Toronto Airport
YYZVAGI	Hilton Garden Inn Toronto/Vaughan
YYZVGHW	Homewood Suites by Hilton Toronto-Vaughan
ZAGCRDI	DoubleTree by Hilton Zagreb
ZCLHXHX	Hampton Inn Zacatecas, Mexico
ZDVGIGI	Hilton Garden Inn Davos
ZNZDTDI	DoubleTree Resort by Hilton Zanzibar - Nungwi
ZNZSTDI	DoubleTree by Hilton Zanzibar - Stone Town
ZQNALDI	DoubleTree by Hilton Queenstown, New Zealand
ZQNHQHI	Hilton Queenstown Resort & Spa
ZRHHITW	Hilton Zurich Airport
ZZVOHHX	Hampton Inn Zanesville

